########        
#   #  #        
# $    ####     
## ##$ #@ ######
 #  $ $##$  #  #
 # #  $ # $ ...#
 # $ #$    #...#
 #     ## $#...#
 ### $ #  $ ...#
   ### #  $#...#
    #  $$  #####
    #     ##    
    #######     
