       #####    
  ######   #####
  #      $     #
  # ####   #####
  # #   $$$   # 
  # # $     $ # 
 ## #### $ #### 
 #  #   $ $   # 
 # ## ## $ ## # 
 # ## ## $ ## # 
 # ##   $ $   # 
## ##   $ $   # 
#  ## ## $ ## # 
# ### ##$ $## # 
# # #  $ $ $  # 
# # ####   #### 
# # #.........# 
# # #.........# 
#@# ####...#### 
###    #####    
