 ####                
##  #####            
#       # #####      
# $###  ###   #      
#..#  $# #  # #      
#..#      $$# ###    
#.*# #  #$ $    #####
#..#  ##     ##$#   #
#.*$  $ # ##  $     #
#..##  $   #   ######
#.*##$##   #####     
#..  $ #####         
#  # @ #             
########             
