 ######           
##    #           
#@$ $ #           
### ###   ####    
 #  #######  #    
 #  $ ....#  #    
 #  ###...   #    
 ##$###...# ######
 ## ###...# #    #
 #     #### # $$ #
 #   #   ## #$ $ #
 #####        $$ #
     #####  #$ $ #
         ####  $ #
            #    #
            ######
