  #####  
  # @ #  
  # $ #  
### . ###
#   *   #
# ***** #
#   *   #
###$*$###
  # . #  
  # * #  
  # . #  
  #####  
