 #######        
 #     #   #####
 #  ## #####   #
 #$ $ $  #   # #
 # $ $ #       #
##  $$ ###$### #
# $    #....#  #
#@#$$ ##....#  #
#  $   #....$  #
##  ## #....# ##
 #$$#  ## ###  #
 #      $      #
 ############  #
            ####
