  #########  
  #       #  
  #$ $ $ $#  
 #  $ $ $  # 
# $  # #  $ #
#   #...#   #
 # #.....# # 
 # #.....# # 
 #  #.#.#  # 
 #$ $ $$$ $# 
 #  #   #  # 
  ### @####  
    ####     
