   #####       #####         
#### @ #########   ######    
# $ $ $ $ # # $ * * $ # #    
#   #.#     #   #.#     #    
## $...$ ## ## $. .$ ## ##   
 #  #.#  #   #  #.#  #   ##  
 ## *.* # $ $ # * * # $ $ ## 
  ##   #  #.#  #   #  #.#  # 
   ## ## $...$ ## ## *...* ##
    # #   #.#     #   # #   #
    ### $ *.* $ ### $ * * $ #
      ####   #### ####   ####
         #####       #####   
