           ####   #####
     #######  #####   #
    ##            # # #
   ##  $ #### ##$   $ #
  ##  $ #   # ##  ##$##
###  $ ## # $.####   # 
#  $$ $ # ###.#### #$# 
#  $@# ## ###.....   # 
#  $$# #  #...#.###$## 
###    #   .....#   #  
  # $ ##  #.....# ###  
 ## #  ## ####$## #    
 #  $ $ #         #    
 # $ $  ###########    
 ##     #              
  #######              
