        #####      
    #####   ####   
   ## $   #    ####
   # $ $    #   $ #
####  $   # $ $ $ #
#  # ####### ##   #
#        $ $$ #   #
#  ####### #  $  ##
##$#  #  ...# # ## 
 # $$  @$...#   #  
 #  $ ####.## ###  
 ##    ##..... #   
  ##   ##..... #   
   #############   
