      ####      
    ###@ ###    
  ###      ###  
###  $####$  ###
#              #
#####$#### #####
    #      #    
    #$ ##$ #    
    # $   $#    
    # $##$ #    
   ##      #    
  ##  ######    
 ##      *.#    
 #  $ $  *.#    
##  #  ##..#    
#  ##$ #...#    
#  ## $ ...#    
#  ###  ...#    
############    
