       #####     
     ###   ##    
     #   #$ #####
   ### $ @ $#   #
####  #  #    $ #
# $   $ $$  ## ##
#   #.#  ### $$# 
## #..###      # 
 # #.*###   # $# 
 #  .....#$##  # 
 ###.*.*.*    ## 
   ########    # 
          ##   # 
           ##### 
