  ##########             
 ##     #  ############  
 #  **  #       ##  * #  
 # *  * # ** ** #  *  #  
##* ** *# * * * # *   ###
#@*       * $ * .* ***$.#
##* ** *# * * * # *   ###
 # *  * # ** ** #  *  #  
 #  **  #       ##  * #  
 ##     ###############  
  #######                
