####    ##########
#  ######   #  ..#
# $ ##   $# #  ..#
# $    #  $ #  ..#
# $ ##### # #  ..#
#  $$ $ $$  #  ..#
#@         $  $..#
#  $$ $ $$  #  ..#
# $ ##### # #  ..#
# $    #  $ #  ..#
# $ ##   $# #  ..#
#  ######   #  ..#
####    ##########
