  ######### #####    
  #       ###   ##   
  # $$ #      $$ ##  
###   ## $ ###$ $ ## 
#   $ # $ $   $ ...# 
# ##$ #    $ $  ...# 
#   $ # @  #### ...##
####   #####    ....#
   # $$     $$ ##...#
   #   #####   ##...#
   #####   #  #######
           ####      
