            #### 
###### #### #  # 
#    ### @###  # 
# $$ $ # $$    # 
#   $#  $ $ #$###
#### ### #$ $   #
   #.....#  #   #
####..##.##   ###
#  #.....   ###  
#   ...#$####    
#  ##### #       
##$###   #       
#  ## $  #       
#    $ $##       
#  ##   #        
#########        
