  #####        
###   ##       
#      #       
# $$ #$########
## #$ $ $ #   #
#....#   $    #
#....@#  ###$##
#....$#   $ $ #
#....$ $#     #
#####   # $#$##
    #####   $ #
        ###   #
          #####
