####                
#..#                
#..#                
#..#####            
#..#   ######  #####
#.. $ $ #   ####   #
#.   #    $  ## $  #
#.. $ $ #  $ $ $  ##
#..#   #### $ $  ## 
########  ## $  ##  
         ## $  ##   
        ## $  ##    
        # $  ##     
        #   ##      
        #@ ##       
        ####        
