   #######     
   #     ######
   #  $#      #
####$  $  #$$ #
#    $$ $   $ #
# $#  ## ### ##
# @##$ $  $  # 
#     $  $ $ # 
##########$$ # 
  #.........## 
  #.........#  
  ###########  
