     #####         
 #####   #         
 #       ####      
 # $$## ##@ #      
 ##  # $  .*#      
  # ##   #..#      
  # ## ###.*#      
  # ##   #..#####  
### #### #.*#   ## 
# $      #..#$ $ ##
# # #$ # #.*#     #
#   #  #$#..  $   #
###### # ####### ##
   ### # ###  #   #
   # $    $     $ #
   # # ##   #######
   #   ######      
   #####           
