     #####     
   ###   #     
   #   # #     
 ###  $  ######
 #  #$#  #    #
 #$ $ ##   $  #
##  #    $$$###
#    ###$   #  
# $#$$...####  
#    #....#    
# # @ #...#    
#     $...#    
##  #     #    
 ##########    
