              ########
              #  ....#
   ############  ....#
   #    #  $ $   ....#
   # $$$#$  $ #  ....#
   #  $     $ #  ....#
   # $$ #$ $ $########
####  $ #     #       
#   # #########       
#    $  ##            
# $$#$$ @#            
#   #   ##            
#########             
