    #####      
#####   ###### 
#     #  ##  ##
# # $$   $    #
#  #   ## # # #
# $ # ##   $  #
#    $ $   # ##
## $ #  #$## # 
 ###  # # # $# 
   # $  @ ...# 
   # $##$#...# 
   ##   ....## 
    ### ...##  
      ######   
