 ###### ##### 
##@#  ###   ##
#    $  # $  #
#  $  #    $ #
### ######   #
### ##  ##$###
# $  #### ..# 
# $ $ $  ...# 
#    ####...# 
# $$ #  #...# 
#  ###  ##### 
####          
