            ####      
 ############  #####  
 #    #  #  $  #   ## 
 # $ $ $  $ # $ $   # 
 ##$ $   # @# $   $ # 
###   ############ ## 
#  $ $#  #......# $#  
# #   #  #......## #  
#  ## ## # .....#  #  
# #      $...... $ #  
# # $ ## #......#  #  
#  $ $#  #......# $#  
# $   #  ##$#####  #  
# $ $ #### $ $  $ $#  
## #     $ $ $ $   ###
 #  ###### $    $    #
 #         # ####### #
 ####### #$          #
       #   ###########
       #####          
