#########     
#       ##    
# #$#$#@ #####
# $    $ #   #
## #### ## # #
#  #  #      #
# $#  $  #####
#..$  ## #   #
#..#  #   $$ #
#..####  $   #
#*...# $ $ $ #
#....#       #
##############
