 #####################
##                   #
#    $ #      ## #   #
#  ###### ###  #$## ##
##$#   ##$#....   # # 
#  #    $ #....## # # 
# $ # # # #....##   # 
# $ #$$   #....##$# # 
# # $@$##$#....##   # 
#   $$$   #....#    # 
#  $#   # ###### $### 
##  # ###$$  $   $ #  
##     # $  $ ##   #  
 #####   #   #######  
     #########        
