 #####    #####     
##...######   ######
# ....##  # $ ##   #
# . ..#   # $   $$ #
##....# $ ## ###   #
 #....#  $     # ###
 #$##### ###   # #  
 #    ## #   ### ## 
 # $$$## # $$@  $ # 
 #  $ ## #   ## $ # 
 ## # ##$ #####   # 
 # $ $     #  ##### 
 #     #   #        
 ###########        
