  ##############################
 ##       #   #    #   ##   #  #
##  ### $  $  $ # $ $  $    $  #
#..    $ #####   $ $ #####   # #
#..########       $ #    #     #
#.........# $###### # @$ #  #$##
#.........#  ##  ## ###$$###   #
#..#.#.#..#$## $  # ## $  #  # #
#...#.#.. #  #  $ #   $    $ # #
#........ #  ## # # $$ $ $$  # #
#.....#.. #  ## # #  $ $$  # # #
######## ## ##    #  #   ### # #
#  #      #   $  ######  $ # # #
#  $$##      # ####   #    # # #
# $$  # #### ###  # # #### #   #
#    $# $  #$  # $ $ $#  $ # # #
#  $ $   $ $ $  $  #           #
##   #####     ###    ######  ##
 #####   ####### ######    #### 
