  ####                  
  #  ###                
###    ########         
#  $ $  #     #         
# $ $ $   $   ########  
#  $ $  ## ####      ###
##  $ $ # $$ ##    #   #
 ###@####$   ## # #### #
  # $ $ #  $$ #.....#  #
###$ $  # $   #.....#  #
#   $ $  $$$  #....... #
#  $ $  #  ####...... ##
####   ##  $   ...... # 
   ############ ##$#### 
              #    #    
              ######    
