###########    
#   ##....#####
#  $  ...##   #
###$$ ..### # #
  # ##...##$  #
  # #   ###  ##
 ## # $  $ $ # 
 #  # # #    # 
 #    # $ #$ # 
 # $$ # $#  ## 
 ### ##  # ##  
   #@      #   
   #########   
