          ####### 
       ####  #  # 
########   $    # 
#.....## ## ##  # 
#..... $  # ## ## 
#....  $#$     #  
### ###    ## $###
 ## #  $$# ## $  #
 # $# #    #   # #
 #  # ## # $ ### #
 #  $$ $ #  #    #
 ####   $###  ####
    ###   @  ##   
      #  #####    
      ####        
