      ########## 
 #### #  ## #  # 
 #  ### $#  $$ # 
 #             # 
 # ## ##$###  ## 
##  $ # $  ##$ # 
#  ####  # #   ##
#  # $   $ # $  #
#    $ #...#    #
##$ $ # ...######
#@  ### ...#     
##### ###..#     
        #..#     
        ####     
