   ####             
   #  ####          
   #     ##         
   # #$$  #         
   #   $ $###       
  ##   ##   ##      
  #    #  #  ###    
  # #  # $  $$ ##   
  #    ##$# $   ####
  ### # $   # $  $ #
###...#  @$###$ $# #
# .... #$# ##      #
# #...     #    # ##
# ...## $  $ $ $  # 
##....$ #      #### 
 #.... #########    
 #######            
