           #######  
       ##### ....#  
       #     ....#  
       # ### ....#  
 ####### ### ....###
 #  #  # #####$  $ #
## $  $#@    #  #  #
#    $$ #$$$$## #$ #
# $$$        $     #
# #   # #    #  ####
#   # $ #########   
######  #           
     ####           
