  ####                    
  #  ####       ####      
  #$    ####   ##  ###### 
  #  #  $  #####   $    # 
  # ##  $  #@##  $ ###  # 
  # ##### # $# $$ ## $ ## 
  # #...# #  #$  ###  $ ##
 ## #...# #$ # #...#$  $ #
 #  #... $   # #...#   # #
##  $...# ## # #...$$#   #
#  #$...#$     #...# # # #
# $  ## #  $    ...    $ #
####     $ ###### ## $ ###
  #  #$ #  #   #  $ $###  
  # $ $ ####   #     #    
  #  ####      #######    
  ####                    
