 ####### ####         
 #     # #  #######   
 # $@$ ###  $     #   
 #####  ## $# $#  #   
 #....  ##  #  #  ### 
 #.....    $# $# $  # 
 ##..#.#$#  #  #  $ ##
 ##.#..# # $# $# # $ #
 #.....# #  #  #$    #
 #....## # $# $#  $  #
 # ####  #  $  ##$ $##
## #####  ###  #     #
#         # # $###$$##
#   ####  # #   $   # 
#####  #### ####   ## 
               #####  
