   ####                
  ##  ###              
###     #              
# $  $  #  ####        
#@ # #######  ##       
# $   # $      #       
##  $## $$#  # #       
 ##   $    #   #  #### 
  #  ###$ $ $ $# ##  ##
  #### #   # $ # # ...#
       #  $ $  # # ...#
       ###$ $$ ####...#
         #  #   $.....#
         ##    $ *# ..#
          #####  ....##
              ######## 
