        ####                    
    #####  ###         ######## 
    #   #  $ #   #######  ##  # 
    #        #####  #  #      # 
    ## # ##      #$    $  ##  # 
    #  #...    ##  ##  #$    ###
    ##.#*######  #  # #   ##   #
    # .....      $  #  # #     #
    # $ #  ###  ##  #  ## # $  #
#######$## #   #..### #   #  ###
#   #     # #  # *....#  # ###  
#   $    #  ## # .## .#    #    
##$# # #@# $  # ..#  # #   #    
 #  #   #   #  ##*.## $ $  #    
 ##   $ ##  #$$     #    $ #    
  # $$       $ ##  # # #####    
  ###  #  #  # #  #  #  #       
    ########   #        #       
           ######  #   ##       
                ########        
