             # 
            ## 
           ### 
          #   #
   ######## # #
  # $ $ $ $   #
 ## #.#.#.#@$# 
###.......   ##
 ## # # # #$## 
  # $ $ $ $   #
   ######## # #
          #   #
           ### 
            ## 
             # 
