        ######              
        #   @####           
      ##### $   #           
      #   ##    ####        
      # $##  ##    #        
      #   #  ##### #        
      # #$$ $    # #        
      #  $ $ ### # #        
      # #   $  # # #        
      # #  #$#   # #        
     ## ####   # # #        
     #  $  ##### # # ####   
    ##    $     $  ###  ####
#####  ### $ $# $ #   .....#
#     ##      #  ##  #.....#
# $$$$    ######$##   #.##.#
##    ##              #....#
 ##  ###############   ....#
  #  #             #####  ##
  ####                 #### 
