     #####    
     #@  #### 
  #####$    # 
  #...#  # $##
  #.*.#$ #$  #
###... $ # # #
#  ..##$#    #
#  ####  # $ #
##   $   #$$ #
 #  ## ##   ##
 #####      # 
     #  ##### 
     ####     
