                #####   
       ###### ###   ####
   #####    ### $ $  $ #
####  ## #$ $    $ #   #
#....   $$ $ $  $   #$##
#.. # ## #   ###$## #  #
#....    # ###    #    #
#....    # ##  $  ###$ #
#..######  $  #  #### ##
####    #   ###    @  # 
        ############### 
