             #####   
  ########   #   #   
  #      #   # $ #   
  # #### #   # $ ##  
  # #  # #######  ###
  # #    ##    # $  #
  # # $#### ## # #  #
  #$ # #### ## #.#  #
  #  #   #  .....# ##
###  # # #  #....#  #
#  $ #$# ## #.....  #
#  $ $    # #....#  #
#  $$ $   # ###.## ##
### $ ##### # $  # ##
  #         #   $#  #
  #$#$$ $ $ #       #
  # # ###########   #
  # @ #         #####
  #####              
