#######
#  .  #
#  .$ #
# $*. #
#* .$*#
# **$ #
#  .$ #
# $. @#
#######
