###########
# $. $ .  #
#  #  $.  #
#..*..#*#.#
#$$#$$$. $#
#  .$@$.  #
#$ .$$$#$$#
#.#*#..*..#
#  .$  #  #
#  .$ $.  #
###########
