  #######        
 ##  #  ####     
## $ $     #     
#    # ##  #     
# # #...#$#####  
# # #...   $  ###
# # ....#   #   #
# ##....#$$  $  #
#  ## ###  ## $ #
#@$##      # $  #
##   $ # $   $# #
#  ###### ##    #
#       $ #######
#######   #      
      #####      
