  #####          
###   ##         
#   #  #         
# # $$ ##########
# $$   ##  #    #
##   $ #  $$$ # #
 # #$ $$ $ #  $ #
 #  $ .#.....$ ##
###@##..##.#.### 
#  #  #......#   
#         $###   
#      #   #     
#     ######     
#######          
