######   #####
#    ### #  .#
#  $ $ # #...#
# #  $ ###  .#
#  $$$   $ @.#
###  $  $#  .#
  #  $#$ #...#
  ##     #  .#
   ###########
