        #####      #####       
      ###   ########   ##      
#######                 #######
#.............................#
#............*...*............#
###$### ##### ### ##### ### ###
# $  #    #  $ # $  #  $ # $  #
#     $   # $$ $ $$ # $ $ $ $ #
# $ $$$$  #  $   $  #  $   $  #
## $ # $$### $ # $ ###$ $#$ $##
# $ $ $ $ #  $$ $$  #  $ $ $  #
# $  $    # $$ $ $$ # $ $ $ $ #
#         #    @    #         #
###############################
