#########         
#   #   ##########
#  $ $  #   #....#
## $ $ $ $  #....#
 #@$ $ $ $ $.*.#.#
 # $ $ $ $ $.*.#.#
## $ $ $ $  #....#
#  $ $  #   #....#
#   #   ##########
#########         
