####           
#  #           
#  ##########  
#    ##     #  
#..#    $$# #  
#..  ##   $ ###
#..#  ##$# $  #
#..   # @$ $  #
#..#  # $ $   #
# .   # $ $ ###
#  #  #   ###  
#  #    ###    
#########      
