       #######
    ####.....#
#####   .....#
#   #  #. ...#
# $@## ### ###
#  $   $  $$ #
#   #$   $   #
# $ # ##$  $ #
###    $ ##  #
  # $ $ $   ##
  ###    #### 
    ######    
