        #######
    #####     #
 #### $ $ $ $ #
 #  #  $ ###  #
 #    @    #$ #
 # ### ###    #
 # #.....# $$ #
 # #.....#  $##
##$#.....$   # 
#    ## #  ### 
# $ $   $$ #   
##  #####  #   
 ####   ####   
