##############################
#           #     #     #   ##
# #$### #$#$#$#$$ $ #$#$# #  #
# $     #         #     #  # #
# # $#  # # # ## # # ##  # # #
# $  # @      ##         # # #
# ##  #######    ####  ##  # #
#       ....# #  #      # #  #
# ### # ##### ## #  ## ## #  #
#   # # #  #        #     #  #
# # #     $# $ ##     ###  # #
#     # #  # ##  # #    #  # #
# # # #  # #     $ $ #  ...  #
#   # #         # # ## #...# #
# #   ### # # #         ...#.#
#       $$$ # #  ### # ##  #.#
# #$##### #   ##   ### #####.#
#                        ....#
##############################
