           ######
       #####    #
     ###  #   # #
    ## $ $  $$  #
   ##  #   #$  ##
 ###     # # # # 
 # $ #$ $  #   # 
 #   @ ##$# $ ## 
 ##.## $      #  
##...   $#   ##  
#.... #$ $ $  #  
#...#   #  #  #  
#.... $### #$ #  
##...  # # $  #  
 ##   ## ##  ##  
  #####   ####   
