    #########    
    #       #    
    #$$ $$# #### 
#####  #  $ #  # 
#..#  ## $  $  # 
#..# $$     #  # 
#..#  ##$#### ## 
#..## ##    # #  
#...   ## ### ###
#   ##   $      #
######@#   #  # #
     ########   #
            #####
