        #####   
       ##   #   
      ## $ $#   
     ##.*   #   
    ##.*. $$#   
   ##.*..#  #   
  ##.*..## $#   
 ##.*..###  #   
##.*..#### $#   
# *..#####  #   
# $ ###### $#   
#  #######  #   
# $####### $####
#            $ #
# $ $ $ $ $@   #
##########  ####
         #$ #   
         #  #   
         ####   
