  ########    
  #   #  ###  
### # $  $ ###
#    #$$ #   #
# ##$#  @  $ #
#    $$###$ ##
#   $# ##  ## 
# #$ # ...##  
# $ #.....#   
##  .....##   
 # $# ####    
 ##   #       
  #####       
