###############
#      #      #
# $ #$ # $##$ #
# #  $ #      #
#   ##$#$##$$ #
# # # ... #   #
# $  . # .$ # #
# $#@$...# #  #
#    . # .  $ #
# ##.$###$. # #
# # $..... ## #
#             #
###############
