         ####                
         #  #                
         #  ########         
   #######  #      #         
   #   # # # # #   ##        
   # $     $  ##  $ #        
  ### $# #  # #     #########
  #  $  #  $# # $$ #   # #  #
 ## #   #     ###    $ # #  #
 #  #$   # ###  #  # $$# #  #
 #    $## $  #   ## $  # # ##
####$ $ #    ##  #   $    ..#
#  #    ### # $ $ ###  ###.*#
#     ##  $$ @  $     ##....#
#  ##  ##   $  #$#  ##....*.#
## #  $  # # $##  ##....*.###
## ##  $  # $ #  #....*.###  
#    $ ####   # ....*.###    
#   #  #  #  #  ..*.###      
########  ###########        
