  ##########    
  #    #   #    
  # $#   $ #    
  # $ $#$# #    
 ###.#...  #####
##  ....#$ #   #
# $#.##*#  $$$ #
#   .....@# $  #
#  #.#...  $ $ #
# $$  $#$#  $  #
#   #  #  #   ##
######    ##### 
     ######     
