           ########    
           # ...  #    
    ####   # .....#    
#####  #  ###.###.##   
#    $ ####...*.*..#   
# $ #     .....*.. #   
## ######$#  ## $###   
 # #    #  ##  #  ###  
 # # ## ##     # $  ## 
 # # ## ## ##  #  #  ##
 # # #  $   $ $# $##  #
 # # #   ####$   $ ## #
 # #  ###     $$ #  # #
 # ##    $  $$$  $$@# #
## ### $####   ###  # #
# $   $ $ ##   ###### #
#   ###    #####      #
###     ##       ######
  ################     
