      #####      
    ###   #####  
    #  $      #  
    #..# # $# #  
    #..#  #   #  
  ###..$$$$ $ #  
###....# $ #$### 
#  ...#  #   $ ##
# #...  $#$ # $ #
#  # # @ #  # # #
## #   #$  # $  #
 #       # $   ##
 ##     ##   ### 
  ############   
