       #       
     #####     
   ### @ ###   
   #  $ $  #   
   # *.*.* #   
  ## .$ $. ##  
 ### *.*.* ### 
####  $ $  ####
   ######  #   
    ##   ##    
