          ######
   ########    #
   #   $   $ $ #
   # # # # $## #
   #     $   $ #
   ########$ # #
  ##      #    #
  #@$  $  # $  #
###### #$ #$#$ #
#....# $  #    #
#.*..### ## ####
#..*.  $  #  #  
#.... $ $    #  
#...##########  
#####           
