        #####        
        #...#        
        #...#########
 #####  #...$       #
 #   ####. .####$$  #
 #$     #...#  #  $##
 #  ### #.###$ #   # 
 # ##   #@  $  ### ##
 # #  # # ##   #    #
## #$ $ #$ ### # $  #
#   $ ###     $  $  #
#  #       ######  ##
##$# ###  ##    #### 
 #   # ####          
 #####               
