    ######         
    #    ######    
    # $$   #  #    
    #  $#$ $  #### 
    ##       $#  # 
   ##  #$###  $ $# 
####  #@ $ $ ##  ##
# $   $     #  #  #
# # $  ###$##     #
#  $ # #....# #####
# $ ## #.... $  #  
## ### #....$   #  
 # $ # #...# ####  
 #     #...#  #    
 #####  ...#$ #    
     ###      #    
       ########    
