     ######           
######  # #           
 #      ###    #######
 # # # ...#   ##   ## 
 #     ...#  ##  $ #  
 # # # #.## ##  $  #  
 #     #.# ##  $  #   
 # # # #.###  $ $ #   
 #     #.##  $ $  #   
 # # # #.#  $ $ $ #   
 #     #.# $ $ $  #   
 # # # #. $ # $  #    
 #     #.*.@##  #     
 ###### ########      
