##############
#       ###  #
# $$ $    $$ #
#     $ ###  #
##$#####  # ##
## # .....#  #
## # ...#.#  #
#   #.....#$ #
#   #.*...$@##
# $ #  ### ###
# $ ### $ $  #
# $$$     $$ #
#   ###      #
##############
