       ########    
     ###  ##  #    
     #    $ $ #    
   ### #      #    
   # $$ # $  ##    
   #  $   ##  #    
   ## $ #$ ## #####
    # $## $ #$ $  #
    #     $     # #
 #######$ ### $   #
##  $ $  $.####   #
#  ## # $#.## #####
#.....$ @ *.#      
#..#.*# $ ..#      
#..... #$####      
#....#   #         
##########         
