   ##########    
  ##  ##    #####
 ##   $  # $  $ #
 #   $##  $$#   #
 #    $   #     #
 #$#### #####   #
 # # ....... @ ##
##   .*.*.*. # ##
#   ###### ###  #
# #$     $    $ #
#   #############
#####            
