        ######          
        #    #          
        #.## #  ########
       ##..# ####      #
#####  # ..# #  #$ # $ #
#   ## #...  $  # $$   #
#    ####..###  #  #$ ##
#   $  ##..### ##$    # 
#   #  ##..#@#$#   $### 
#      ##..#   #$$#  #  
#   #$   ..# $    $  #  
##     #  ### ###  $ #  
 ########## #  # $# ##  
            #$ #    #   
            #  #  ###   
            #######     
