      #####       
####### @ #####   
#       $ ##  #   
# *## ##.###  #   
#  $  # ..  $ #   
# $ $## .*##  ####
####  ##.. ##$ $ #
   # $   . #     #
   # .###.## ##* #
   #  ## $       #
   #####   #######
       #####      
