      ############    
      #  .  ##   #    
      # #.     @ #    
 ###### ##...# ####   
##  ##...####     ####
# $ ##...    $ #  $  #
#     .. ## # ## ##  #
####$###$# $  #   # ##
 ###  #    ##$ $$ # # 
 #   $$ # # $ # $## # 
 #                  # 
 #################  # 
                 #### 
