            ####  
   ##########  #  
   #           #  
   ##*#######  #  
 ####@####### ### 
 #   *   #   *  ##
 #  * *  #  * *  #
 # * $ * # * * * #
 #*  .  *#* *#* *#
 # *   * # * * * #
 #  * *  #  * *  #
 #   *   ##  *  ##
##### ####### ### 
#   # #  *  #   # 
#      * *  # # # 
#######  * *    # 
      #  *  ##### 
      #######     
