      #      
      #      
     ###     
   ##   ##   
  #.$     #  
 #. $$$$$  # 
##  #   #  ##
#  #*#@#*#  #
#   #   #   #
## .$$$$$. ##
 ##.......## 
  #########  
