   ########## 
####......  # 
#   .....#  # 
#  #...... ## 
## ####$##$#  
#@$  $ $   ###
# $$    ##   #
# #  $$##  # #
#   $  # $$  #
#  $  $   #$ #
####   # $ $ #
   #   #     #
   ###########
