##################
#         ## #...#
# $ $$#    $ #...#
# $   #$##$$ #...#
# $$#$  @     ...#
# $ $ $#$ ####  .#
#   ##       $...#
##################
