             ######
  ####  ######    #
 ##  ####  # $  $ #
 #      $$ #   $  #
 #  # ###  #$$   ##
 #  #  ## ##  #$ # 
##  ## # $@$  $ $# 
#....# #   #  #  # 
#....# ##$## $ $ # 
#....# #  ###   ## 
#....# $  # #####  
###### #  #        
     ######        
