    #### ######### ########     
#####  ###   #   ###      ####  
#   # $   $    $  ## $ $  #  #  
#  $   ###    #$#  ## ##  #  ###
## # # #  ####  ##  # #  ## $  #
 # #   # $#  #    # $ # $   $  #
 # #####     # $#  ## #  ##  ###
 # #   $  #  #  #$$$  # ## $#  #
 # #   $  #$     $ #  $  #     #
 # ##$#####  ##  # # #   #  #$ #
 # ## ##########   #  ####### ##
 # ## ############### #  #  # # 
 # ##.#.........  ##  $     # # 
 # ##.#########.#@.# $#$$$  # ##
 # # ..*.........#.##     $ $  #
 # # ..*.*.*.*.*.*.### ### #   #
## ###############  #  $   #####
#  $                #   ####    
#   #####################       
#####                           
