 #########      
 #  #    #######
 #    $   #    #
##.#### $ $@$# #
#....###  ## $ #
#....####$ #   #
#....        $ #
### ####$# $ $ #
#        ##  ###
# $$ $ #######  
#  #####        
####            
