         ####     
     #####  ####  
     #    $ $  #  
     # #$    $ #  
     # #  $  # ###
     #   # $ $   #
 ##### ####$#### #
 #  #  ##....#   #
 # $  $#.....# ###
 # $#  #....##  @#
 #$  $$#.#...# ###
## $$  ##....# #  
#    #$###$### #  
#       $ $ $  #  
#######     ####  
      #######     
