    ######     
 ####    ######
 #  # $    #  #
 # $  #$$  $$ #
 #  $#  #..#. #
##$  # #...*.##
# $ # $ ..##. #
# #$ $ #..... #
#    #  #  ####
# $#  #   @##  
#    $# #  #   
####  $ ####   
   #  ###      
   ####        
