   #####         
   #   ######    
####  $ $   #    
#.  # $  $$ #    
#...$  $ $  ##   
#..##  $$ $  ####
#...#### ## $# @#
# ...#    #   $ #
# ...#    #  # ##
# ..### ######  #
#..##  $$       #
#.## $ $  $ #####
####  $  $ ##    
   #   #####     
   #####         
