   ######       
   #    ##      
   # $ $ ##     
#### #$#  ####  
# $    $  #  ###
#    $ # $.....#
### # ####.....#
 ## #$ $  ..####
 #  #   $#  #   
 #@$  $  ####   
 #  ######      
 ####           
