            #####  
          ###   #  
          #     ## 
         ## #$#  # 
         #  #  # # 
         # ##  # # 
         # #  $# ##
         # #  $   #
######   # # # $# #
#....#   # # $  # #
#....##### #   $$ #
#....#  #  ##$#  ##
##  ##    $#  #  # 
 #     $#    $  ## 
 #@ ##  # $##  ##  
 #  #####  #####   
 #  #   ####       
 ####              
