     #############   
     #    ###    #   
     #     $ $  #### 
   #### #   $ $    # 
  ## $  #$#### $ $ # 
###   # #   ###  $ # 
# $  $  #  $  # #### 
# ##$#### #$#  $  ###
# ##  ### # # #  $  #
#    @$   $   # $ # #
#####  #  ##  # $#  #
  #... #####$  #  # #
  #.......# $$ #$ # #
  #.......#         #
  #.......#######  ##
  #########     #### 
