      ##########
#######       @#
#        #######
#### ##  ## ### 
 #    $ $     # 
 ##### $  ##### 
###   $ $$   ###
#   $ #  # $   #
#  $###$ ###$  #
###   $  $   ###
  #  $ $$  $ #  
  # ###  ### #  
  # ###$ ### #  
  #     $    #  
  #$ $ $$ $  #  
  # ###  ### #  
  #.###..###.#  
  #..........#  
  #..........#  
  ############  
