       #######     
       #  #  #     
  ######  $$ #     
  #   $   #  ##### 
### $  #  # ###  # 
#   $ #####   $$ # 
#     #..*.  ##  # 
#  $ $ ....####@$##
########..###  $  #
       #....$  #  #
       #....#   $ #
       ######$$# ##
            #  $ # 
            #   $# 
            ###  # 
              #### 
