 ####                           
##  ##########                  
#   $     $  #                  
#  #  $ $    ###          ##### 
## ###$#### #  ############   ##
#   #   #   #               $  #
#   #   #  $ $ ############$## #
## ### #### #  ##  ######## ## #
#  $   $   $ ####........    # #
#@$  $   $   ### ........# # # #
## ### #### #  # ........#   # #
#   #   #  $ $ #############$# #
#   #   #   #               $  #
## ###$#### #  ############   ##
#  #  $   $  ###          ##### 
#   $   $    #                  
##  ##########                  
 ####                           
