      ########    
   ####  #...#    
   #  #$  ...#####
#### $   ##....  #
#   $$#$ ##....  #
# $     ####### ##
# ### $#####  $ # 
#  # $ #@#   $  # 
## #    $  $$ ### 
 #   # $ #  ###   
 ###  ##  ###     
   ##     #       
    #######       
