######################
#      #      #      #
# ##.# # #.## # #.## #
# # $# # #$ # # #  # #
# .$ $ # .$ . # #$$  #
#@#..#   #$$#   #..# #
# $ $. # . $. #  $$# #
# #$ # # # $# # #  # #
# #.## # ##.# # ##.# #
#      #      #      #
######################
