   #######         
   #  #  #####     
  ##$     #  #     
  # $ $# $$$ ##    
 ## #  #  #   ##   
##   # $  # #  ### 
#  #$### #...#   ##
#       @..#.#$$  #
# $$# $ #....   $ #
###   ###....#  ###
  ##### #########  
