  ###################  
 ##   *   ###   *   ## 
##   * *   #   * *   ##
#   * * *     * * *   #
#  * * * *   * * * *  #
# * * * * * * * * * * #
#* * *$* * * * *.* * *#
# * * * * * * * * * * #
#  * * * *   * * * *  #
#   * * *  @  * * *   #
##   * *   #   * *   ##
 ##   *   ###   *   ## 
  ###################  
