             #####   
             #   ##  
        ###### $  #  
        #   #  # $###
     #### $ #$      #
######    #    # ## #
#     $$# $ $###$ # #
# $### @$ ## #....$ #
#   ### # $  #.#.. ##
## $   $# #   ....## 
 #  ##    $ #$....#  
 ##  ###  #$ $.#..#  
  # $#####  # ....#  
  #  #  #  ####...#  
  # $$$    #  #####  
  #  # $ # #         
  ##   # $ #         
   ###    ##         
     ######          
