    ####      
 ####  ####   
 #  #   $ ####
 #... $#$ #  #
##.#.  #   $ #
#..... ###$  #
#....#$#  $ ##
###$## $$   # 
 #   #    $ # 
 # $  @$  ### 
 ####$# ###   
    #   #     
    #####     
