   ######  
#####   #  
# $  .  #  
# $ ..###  
#@$ $$###  
### .$. ###
 ##$...$  #
 # $.##   #
 #   ######
 #####     
