         #####  
        #     # 
       #  $##  #
      #  #   $ #
#  #  # #  # # #
 # #  # $ $  $ #
  ####### #$#  #
  #  $ $      # 
  #@..$ **.###  
   #......##### 
    ############
