    #########  ####   
    #   ##  ####  #   
    #   $   #  $  #   
    #  # ## #     ####
    ## $   $ $$# #   #
    ####  #  # $ $   #
#####  ####    ###...#
#   #$ #  # ####.....#
#      #  # # ##.....#
###### #  #$   ###...#
   #   ## # $#   #...#
  ##       $  $# #####
 ## $$$##  # $   #    
 #   #  # ###  ###    
 #   $  #$ @####      
 #####  #   #         
     ########         
