       #### ####    
     ###  # #  #    
  ####  $ ### $#    
  # $   $      #    
###  ## $  $  $#    
#       # $ ## #    
# #$$$$# $$ $  #    
#    $ $$ #### #####
####    $ @## .....#
 #  $$## #### ....##
 # $  #....## ..### 
 # #  $....######   
 ####  ....#        
    ########        
