           ####        
       ## #....##      
      # @#.......#     
     #  #.........#    
    #  #..........#    
   #  #  $$$$$$    #   
  #  $$$ $    $    #   
 #  $$  $$$$  $    #   
#  $  $     $$ $   .## 
#  #$ $ $ $ $ $    ...#
# $ $ $$ $$ $$     ...#
 #                  ## 
  ##################   
