#######
#@ *  #
# $. $#
#$ *  #
#.*.*.#
#  .$ #
# $.$ #
#  *  #
#######
