########            
#  #   #####        
# $ $ $#   ###      
#  $ $     # ##     
# $ # $# #    ##### 
#  #   # ## #  #  # 
# $# ### #####    # 
#  $  ## #... ##$ # 
##    #  #... ## ## 
 ######   ...###  # 
      ####.... $  # 
         #######  # 
             # $ ###
             #   $@#
             ###  ##
               #### 
