            ####  
   ##########  #  
   #           #  
   # $#######  #  
 ####@####### ####
 #   *   #   *   #
 #  * *  #  * *  #
 # * $ * # * * * #
 #*  .  *#* *.* *#
 # *   * # * * * #
 #  * *  #  * *  #
 #   *   ##  *  ##
##### ####### ### 
#   # #  *  #   # 
#   *  * *  # # # 
#######  * *    # 
      #  *  ##### 
      #######     
