              ####   
         ######  #   
         #       #   
         #  #### ### 
 ###  ##### ###    # 
##@####   $$$ #    # 
# $$   $$ $   #....##
#  $$$#    $  #.....#
# $   # $$ $$ #.....#
###   #  $    #.....#
  #   # $ $ $ #.....#
  # ####### ###.....#
  #   #  $ $  #.....#
  ### # $$ $ $#######
    # #  $      #    
    # # $$$ $$$ #    
    # #       # #    
    # ######### #    
    #           #    
    #############    
