#######              
#     ####           
# $ $ #  # ####      
#  $$  $ ###  #######
#### $   $  $       #
  ### ##   ##$# $ $ #
  #@#   ##   $   #  #
  # $$ $   # # $ $  #
  #      $     $#####
  ##$##$###$##  #    
  #..... #    ###    
  #....*.   # #      
  #....##$ $$ #      
  #......$  ###      
  #......####        
  ########           
