#######            
#  #  #     ####   
# $  $#######  ####
#  #  ....... $#  #
## #  ###.###   $ #
 # ##   #.#@#$##  #
## ###$ #.# #  # ##
#      $#.# #     #
#   ##$ #.#   $#$ #
######  $   #  #  #
     ## #$# #######
      #     #      
      #######      
