      #########
      #       #
      #$ $$$  #
      #   # $ #
      #   $@$ #
    ###$ $ # ##
    #   $#$# # 
##### #  #   # 
#...  # $# ### 
#.....   # #   
#.....# $# #   
########   #   
       #####   
