       #########  
       #   #   ###
       # # # $   #
    ####    #$ # #
##### $  $# $    #
#   # $      #####
# # $  ##$##$#    
#     #......#    
### $  ..#####    
  ##  #.. ###     
   ##$ ...$@#     
    #  #.   #     
    #  ##  ##     
    # $$  ##      
    #   ###       
    #####         
