 #################### 
 #         @        # 
 # #############$## # 
 # #    $ $ $ $ $ # # 
 # $              # ##
##$################  #
#  $ ..*...*...*.##  #
#  ##....*...*..  $  #
#  ################$##
## #   $   $      $ # 
 # # $   $   $    # # 
 # ##$############# # 
 #                  # 
 #################### 
