 #####        
##   ##       
#     #####   
# #    $  #   
#  # $ ## #   
## $$#... #   
 ###  ... #   
   ####..#####
######...##  #
#  ### $@ #$ #
# $ #   #    #
#  $  #$  $ ##
##    $  #### 
 #####  ##    
     ####     
