   #####   
   #   #   
   # $$#   
#### . ####
# $ *.*   #
# $.....$ #
#   *.* $ #
#### . ####
   #$$$#   
   # @ #   
   #####   
