     #########
     #       #
     #  $#$# #
 ######  # $ #
 #   # $  $  #
## $     ### #
#   #$####   #
#    $ ### ###
#####.. @# ## 
   #...$ $$ # 
   #...#    # 
   #...###### 
   #####      
