      ######             
   #####   #             
   #   # # #####         
   # $ #  $    ######    
  ##$  ### ##       #    
###  $$ $ $ #  ##   #####
#       $   ###### ##   #
#  ######## #@   # #  # #
## ###      #### #$# #  #
 # ### #### ##.. #   $ ##
 #  $  $  #$##.. #$##  ##
 #  # # #     ..## ## $ #
 ####   # ## #..#    $  #
    #####    #..# # #  ##
        ######..#   # ## 
             #..#####  # 
             #..       # 
             ##  ###  ## 
              #########  
