        ####  
  #######  ## 
  #    ##   # 
  # #   $.# ##
  #   $ #. @ #
  ##  ##...  #
   ##$ $... ##
  ##  ##.*.## 
### $    ###  
# $$ #$#$##   
# #     $ #   
#    ##   #   
###  ######   
  ####        
