          ####    
          #  #    
       ####$ #    
########     #####
#   #### @#  ##  #
# $ #   #$# $$   #
#   $ $ # $  #$. #
##$##   # #### #*#
## ##$###    # #.#
## #    $ #$ # #.#
## # $ ## $  # *.#
## #   #  ###  #.#
#  ##### ##.#$...#
#      $  #....###
#  ####   #.*...##
##################
