   ##########        
   #........####     
   #.#.#....#  #     
   #........$$ #     
   #     .###  ####  
 #########  $ #   #  
 #     $   $ $  $ #  
 #  #    #  $ $#  #  
 ## #####   #  #  #  
 # $     #   #### #  
##  $#   # ##  #  #  
#    ##$###    #  ## 
# $    $ #  #  #   # 
#####    # ## # ## ##
    #$# #  $  $ $   #
    #@#  $#$$$  #   #
    ###  $      #####
      ##  #  #  #    
       ##########    
