    ###########    
 ####         #### 
 #    # $## #    # 
 # ## #$ .$ # ## # 
## #    #.$$   # ##
#    ##$#.# ##  $ #
# # ........... # #
# #  ##$#.#@##$## #
# ##$  $ .#$ $    #
#    # $ .   ## ###
#### ##$##$$##  #  
   #           ##  
   #############   
