#####     ######    
#   ##   ##    #    
# $  ### #   # ###  
# $$   # #$$$#   #  
# #  # ###       ###
#  #  $$  $##$#  $ #
##$#   ###      #$ #
 #  $ #..#$$#$#    #
## $# ...#       ###
#     .... $@ #...# 
# $ $#..##  $##.#.# 
# #$  ..#  #  ....# 
#    #   $$#$ ....# 
######   #    ##### 
     ##   # ###     
      ##    #       
       ######       
