     ######       
     #    ##      
     # #$  #      
     #    $#      
######$ #  ##     
#        #  ####  
# #$ ##$     $ #  
# $ $   ##$#   #  
# $  ##$ $  # $###
###.##  # $    $ #
  #... ##  $##   #
  ##..  @## $ #$##
   #..#       # # 
   #....#$##$   # 
   #....     #### 
   ###.. #####    
     #.. #        
     #####        
