 ##################### 
 #   ##  #   #   #   # 
 # $     $   $   $   ##
##### #  #   ### ##$###
#   # ##$######   #   #
# $   # ......#   # $ #
## #  # ......#####   #
## #########..#   # ###
#          #..# $   #  
# ## ### ###..## #  ###
# #   #   ##..## ###  #
#   @      $..#       #
# #   #   ##  #   ##  #
##### ############## ##
#          #   #    $ #
# $  # $ $ $   # #    #
# #$## $#  ## ##    # #
#  $ $$ #### $  $ # # #
#          #   #      #
#######################
