   #####      #####   
  ##   ##    ##   ##  
###  $  ######     ###
#  #$ $ #   #        #
# .     $   #    $   #
# .####$##@##  $  #  #
##.#  $ #   $ #$$ #.##
 #.# $  #   #  $  #.# 
 #.#   $ #####    #.# 
 #.#  $  #   #    #.# 
 #.# $  #  $  #   #.# 
 #.#   #  $.$  #  #.# 
 #.#  #  $.#.$  # #.# 
##.# #  $.###.$  ##.##
#  ##  $.#   #.$  #* #
#     $.## # ##.$    #
##  ###    #    ###  #
 #### ########### ####
