     ######   
 #####    #   
 #  #  $ $#   
 #  $ # $ ### 
##  #  #  $ ##
# $#  @ #    #
#    $ $# $$ #
#  $ #$.*. ###
##  # $...##  
 #### #....#  
    #  ....#  
    ########  
