 #### #####    
 #  ###   ##   
 # $  # #  ##  
 # $# # ##  ## 
 #   $  # $  ##
 # $  $ #$ $  #
### # ### # $ #
#     #....#  #
# # $$ ....## #
# #   #....   #
#  ##$#....#@##
# $ $   # #### 
##    # $ #    
 ###### $ #    
      ##  #    
       ####    
