    ######          
   ##    ##   ##### 
  ##  #$  #####   # 
  # $   #  ##   #$##
  # ##  #   # # $  #
  #   $ $$  $    # #
  ## $ ##  ## #    #
  #  @$$ # $ $######
  #  #  $ ##  #     
  ## ##  $   ###    
 ## ..##..##   ##   
##  .....### #$ #   
#  ##...# $     #   
#   ...#  ## $  #   
## #...  #### # #   
 #  ### ##  #   #   
 ##     #   #####   
  #######           
