  #########     
  #    #  #     
### #$  $ ####  
#  $  ##..#  ###
# #  $ #..$ $  #
# $$  $#..  #  #
##  #  ...#$   #
 #$ @ #...# $ ##
 #    #...$  ## 
 # ##$ ###   #  
 #   $     ###  
 #  ########    
 ####           
