   ####               
   #  ######          
  ##    #  ########## 
  #   #  $ #  #     # 
### # ###  # $  $ # # 
#   #*  ## #  ## ## ##
# ###@#  # ##...$$ $ #
#  .$.$.$    .*.  #  #
### #$## #$##..#  # ##
  #  .#    ###.## # # 
  ###$# #### #.  $  # 
    #   #    ###   ## 
    #####      #####  
