 ####           
##  ############
# $ $ $ $ $ $ @#
# #         $  #
# #  ####*###$##
# #  #.....#  # 
# #$ #.***.*  # 
# #  *.....#  # 
# # $#######$$# 
#             # 
########### # # 
          #   # 
          ##### 
