    #######      
    #     ##     
    # # $  #     
    #  #$# ####  
   ###  $   $ ###
   #  # @ #$$   #
   #    $#  # # #
####$#$#        #
#   ....# $##  ##
# $ #...#$  #### 
### ....  #  ##  
  ####..#$#   #  
     #..   $$ #  
     #  ###   #  
     #### #####  
