#######        
#     #        
# $ $$#        
#@ $  #        
# $ $ #####    
# $  *....#    
#####.###.#    
   ##.# #.#    
   # .###.#####
   # ....*  $ #
   #   ## $ $ #
   ######  $  #
        #$$ $ #
        #     #
        #######
