       ####  ####      
     ###  # ##  ###    
    ## .. ###   $ ###  
    #.... #     #   ## 
  ###... #   $## $   # 
  #  ... # #    $  $ # 
  # #.. #   ## $  # $# 
 ##   # $ $   $  ##  # 
##... ## $# #  #### $##
# .#.###  #$  #   # $ #
# ... $ #    #  $@# # #
# $  #$   $###   $$$  #
###    #            ###
  ###################  
