  ####              
  #  ####           
###$ @  #           
#....# $###         
#....#  $ ##########
#....# #$          #
#....#    # $ ## $ #
#....##$###$$### ###
##$###  #      # #  
 #  ##    # ## # #  
 # $#  $ ## ## # #  
 #  $ ## $   # # #  
 # $##     $ $ # #  
 #   # #$ ###### #  
 #   # # $       #  
 # $#  ##  ####  #  
 #    ######  ####  
 ######             
