  #####           
  #...#########   
  #...#    #  ### 
  #...$  #  $   ##
###...# $##    $ #
#  ...#$  #$# $@ #
#  # $  #$  $ ####
## #  # #  $  #   
 # #### $ $ ###   
 #  #### $ ##     
 #$       ##      
 #  #######       
 ####             
