            ##### 
  ######### #   # 
 ##       ### #$# 
 #  $ # $ $ #   # 
 #  $### #   #$ ##
###  ###   $     #
#   #    $ # $   #
# $$#$##$# ####  #
# @$  ....$#  ####
#### $.... #      
   ## ....##      
    ##....#       
     ######       
