          ###          
         #   #         
        #  $  #        
       # # @ # #       
      # #  *  # #      
     # #  * *  # #     
    # #  * * *  # #    
   # #  * * * *  # #   
  # #  * * * * *  # #  
 # #  * * * * * *  # # 
# #  * * * . * * *  # #
 # #  * * * * * *  # # 
  # #  * * * * *  # #  
   # #  * * * *  # #   
    # #  * * *  # #    
     # #  * *  # #     
      # #  *  # #      
       # #   # #       
        # # # #        
         # # #         
