   #####         
   #   ## ####   
  ## $$ ###  ##  
###..*.  ## $ ## 
# $.##.#$$     # 
# $....  $ $##$# 
# #.#..#$   #  ##
# #....# # #@   #
#  ....# $    $ #
##$#$#$   #  #$##
## #   $# ##   # 
#  $  #   ###### 
#  # ######      
# $  #           
#   ##           
#####            
