 #######            
##     #            
#  ### #      ######
# $    ########....#
## # #$  #  $......#
 #$ $ $  #$ $*.....#
 #  $    $ $ ##....#
 # #$$#  #   #######
 # $  ####  ##      
 # $ $   ## #       
##  $ $$    #       
#@   #   #  #       
#############       
