    #####        
    #   #        
    #$  #        
  ###  $###      
  #  $  $ #      
### # ### #######
#   # ### ##  ..#
# $  $      @ ..#
##### #### #  ..#
    #      ######
    ########     
