          ######
          #    #
#####   ### ## #
#.. ##### $  # #
#..     $   $# #
#..  ## ##   # #
#.. ## $ #$ $# #
#.. #     $  # #
#.. #  $ ###$  #
#.. # $ $  $ ###
### ## # $    # 
  #    #@## $ # 
  #########  ## 
          ####  
