 ####              
 #  ######         
 # $ $ $ #         
 #    $  ####      
 # ##$#   $ #######
 #    # $   $ #   #
 # #$$##$ $ $   @ #
 #    ## $  ##....#
##$$ $## $$$#...#.#
# $ $ ## $  #.....#
#  $  #  $  #..#.##
#     #  $$ #..#..#
###  ###    #.....#
  #  # #$$$ #.....#
  #### #   ########
       ##  #       
        #  #       
        ####       
