####           
#  ####  ##### 
# $   ####   # 
# $    ##    # 
# ###$ $  $  ##
# # $  $ ##   #
#  $ #$$#   # #
##   #  #$    #
 ##  ##  $ # ##
####.###  $# # 
#  #.#.. #   # 
#  #.... @ ### 
# $ ....# ##   
#   ##..  #    
###########    
