       ########
       #  #   #
 ####### $$...#
 #        #...#
 # ######$#...#
## #      #...#
#  # #$ $ #####
# # $ $ $ #    
# @  $ #  #    
#####$ $$ #    
    #     #    
    #######    
