       #######           
       #  #  ####        
       # $#$ #  ##       
########  #  #   ########
#...   # $#$ #  $#  #   #
#....  #     #$  #      #
#....    $#  # $    #$$ #
#....@##  #$ #$  #  #   #
#.... ## $#     $########
########  #$$#$  #       
       # $#  #  $#       
       #  #  #   #       
       ####  #####       
          ####           
