#########    
#       #####
# #    .....#
#   ## ...*.#
## #### # #.#
## #  # $ #.#
#      # $$.#
# $ # $#  $.#
##$  $ $ #$##
 #  #    @ # 
 ####$ $ $ # 
    #   #### 
    #####    
