##################
#  #  #          #
#@ $  #     $#$$ #
##$#  #####..# $ #
#  #  #...#.*# $ #
## #  *...#..* $##
#  #  #...*..#   #
#  #  #.*.#..#   #
## ########### $ #
#  $         ##  #
#   $$$$$$$$$  $ #
#            ##  #
##################
