      ###      
     #   #     
    #  *  #    
   #  * *  #   
  #  * * *  #  
 #  * * * *  # 
#  * * * * *  #
#.* * *$* * *@#
#  * * * * *  #
 #  * * * *  # 
  #  * * *  #  
   #  * *  #   
    #  *  #    
     #   #     
      ###      
