#########
#   @   #
#$ $ $ $#
# $ $ $ #
#$ $ $ $#
# $ $ $ #
#*.*.*.*#
#.*.*.*.#
#.......#
#########
