     ####      
  ####  #      
### $ $ #      
#  $  # #      
#       #######
# $#$$$ $ #   #
##     @#     #
 #$ $ $##### ##
 #  #  #.....# 
 #$ $ #..... # 
 #  ##..... ## 
 #$         #  
 #  ##  ##  #  
 # $#########  
 #  #          
 ####          
