    #       #        
   # #     #.#       
  #   #   #...#      
 #  $  # #.....#     
#  $$$  #...$...#    
#   $   #..$$$..#    
# $ $ $ #..$.$..#    
#  $@$  #.......#    
 #  $  * #.....# #   
  #   #   #...#   #  
   # #  $  *.*  $  # 
    #   $   #    $  #
    # $$$$$ # $$$$$ #
    #   $   # $   $ #
    #  $$$  #  $$$  #
     #     # #     # 
      #   #   #   #  
       # #     # #   
        #       #    
