          ########          
         ##      ##         
        ##  ####  ##        
       ##  #    #  ##       
       #  #  ##  #  #       
       # #  #  #  # #       
       # # #    # # #       
       # #  #  #  # #       
       #  #      #  #       
########   #    #   ########
#           #  # $$ $ $    #
##          #  # $  $ $   ##
 ##    @    #..# $$$$ $  ## 
  ##   ######..#      $ ##  
   ##  #  ..#..# $$$$$$##   
    # ##.......# $     #    
    #   ....#..  $$$$$ #    
    #  #....#  #       #    
    ####################    
