#############################
#  *    #    .    #    .    #
# $*$ # # # $.$ # # #$$*$ # #
#  .  # # # $.$ # # #.$.$.# #
# $*$ # # #*...*# # # ... # #
#$.*. # # # $*$ # # # $.$ # #
#. .$.# # #  *  # # # $*$ # #
# $. @# # #  *  # # #  .  # #
####### # ####### # ####### #
  # $.    # #  .    # #  .  #
  #  .  ### #.$*$ ### # $.$ #
  #$$*$ #   # ..  #   # *.$ #
  #..*..#   #$$*$$#   #.$*$.#
  # $*$ #   #  .. #   # $.* #
  # $.$ #   # $*$.#   # $.$ #
  #  .  #   #  .  #   #  .  #
  #######   #######   #######
