  ##########             
 ##        #             
 #  #$#$#  #      #####  
 # $     $ #    ###. .#  
 ## ##### #######. . .#  
###         $ #  . . .###
#  $#$#$#$#$# #   ##.# .#
#          $  ##...     #
##$#$#$#$#$#$ @  # #.  .#
 #           ## ...#...##
 ##### #####$##  # ##### 
    # $       #    #     
    #  #$#$#  ######     
    #         #          
    ###########          
