          ###########           
         ##         ##          
####    ##  ### ###  ##     ####
#  #   ##  ##  $  ##  ##    #  #
#  #####  ##  $ $  ##  ######  #
#        ##  $ $ $  ##         #
# ###### #  $ $ $ $  # ####### #
#......# # $ $ $ $ $ # ##......#
#......# #  $ $ $ $  # ##......#
# .##### ##  $ $ $  ## ######  #
## #   #  ##  $ $  ##  #    # ##
 # #   ##  ##  $  ##  ##    # # 
 # #    ##  ##   ##  ##     # # 
 # #     ##  ## ##  ##      # # 
 # #      ##   @   ##       # # 
 # #       # ##### #        # # 
 # #########  # #  ########## # 
 #            # #             # 
 #  ########  # #  #########  # 
 ####      #### ####       #### 
