       ######               
   ##### .  #               
   #  ##*.# ############    
   # $ . .#.    #  #   #    
####  #.$ #. #    $  $ #    
#  ## #. ##.$#$# # ## ###   
# @   #.$... #   #  #$  ### 
#  ##$#...$#####$## $ #   # 
##    ###.    $   $ # # # # 
 #  #$## .$#    #   # # $ # 
 ## $ #  ..#$#### ### $ # # 
  #      ### #     $  ### ##
  ## ### $     $#$##$  .   #
   #  ## #####  #  # #$.#$ #
   ## $ $ #  ##### . # .#  #
    #     #    #  $.$##. ###
    #######    # $#. ... #  
               #   ...$ ##  
               ###  #  ##   
                 #######    
