###########
########  #
####     ##
#   $  $ ##
### # # ###
#     $   #
### #$# ###
## # . # ##
# # $.$ # #
 ##.....## 
### $*$ ###
#### .@####
###########
