   #######
####     #
#..#$#$$ #
#... $@# #
#.   #$  #
#..#$$ $ #
####     #
   #######
