  ################  
###      * *  *  ###
#   * **...$*      #
#  * *   #    *  * #
#** $ *######******#
#  * **  #  *  *   #
#   * *$@*   *  *  #
###   *  * *   * ###
 #################  
