      ####            
      #  ############ 
      #             # 
      # #####@#   # # 
      # #   ### #   # 
####### #    ## ##### 
#    .# ###  ##    ## 
#   ..# # #$$  $$$$ # 
#  ...# # #  ##     ##
# ....# ### ### $$$$ #
#         ...###     #
#  ############# $$$ #
####           ##    #
                ######
