################################
#       #  #  #  #            .#
#   #              ##   # ## # #
#    # # ## ## # #    #        #
## #   # #     #   #   # ## ## #
#    #     # ##  #   #   #     #
#  ##   #        # #  ##   #  ##
##  #   ## #  # #  #       #   #
#     #  #   ##     # ## # # # #
#  #  #   #     # #   #  #   # #
#  # ## #   ##  #   #   #  #   #
#         #    #   ##      # # #
## ###  # # #    # #  # ## #   #
#  #   #       #        #     ##
#     #  # # #   ## # #   # #  #
##  # # #      #        #   #  #
## ##   # ## #   # # ##  #    ##
# $          ## #     #     #  #
#@ #  #   #       ##    #      #
################################
