      #####  
     ##   #  
     # $ $## 
   ###     # 
   #   $ # # 
####@ $ ##$##
#  ###$#    #
# $...*.    #
#  ##...##$##
## ##.##   # 
#        ### 
#   #  ###   
########     
