#########
#.  .  .#
# $*$*$ #
# * @ * #
#.$ * $.#
# * $ * #
# $* *$ #
#.  .  .#
#########
