###############
# . . . .     #
#.$$$$$$$.# # #
# $.....$ # # #
#.$.$$$.$.#   #
# $.$@$.$ #####
#.$.$$$.$.#    
# $.....$ #    
#.$$$$$$$.#    
# . . . . #    
###########    
