#################
#   #       #   #
# $ $   #   $   #
# # $#$###$###$##
#    #  $    #  #
# #### $##*# #  #
#   $   #....#  #
##$  ## #*##.#$##
#  $ #  #....*  #
# $#$#  *..###  #
#@   #  #....#  #
#################
