 ######### 
##       ##
#  #$$$#  #
# # .#. # #
#   ...   #
# # ... # #
# ###.### #
#   #.#   #
### $ $ ###
 # $$$$$ # 
 #   @   # 
 ######### 
