     #####  
   ###   #  
####     #  
#  #    ### 
#   #$##  # 
#   #..$  ##
##  $.+#   #
 #  ##$#   #
 ###    #  #
  #     ####
  #   ###   
  #####     
