        ####      
      ###  #      
     ##    ##     
     #   @  #     
    ##$   $ #     
  ###    ## #     
  #   ##..# #     
 ##$##....#$###   
 #  ##....#   ### 
 #$ ##....  #   ##
 #    ....# $$$  #
 #$ ##..##  $ $  #
##  ##..#   $  $ #
# $ ## ## $ $ $  #
# $ $ $ $ $  #####
#     #    ###    
############      
