#########  #########    
#   ##  ####  #    ##   
#  ... .#. . ...#. .### 
# ##.##... .#.#.#..   # 
#  #. #. .#.#. . . .# # 
##     #    ####   ## # 
 ###     #  #     #@  # 
   ##$#  ### $$ ## $####
   #  ###  #$  #   $   #
  ##  $ #     $ $    $ #
  # $$  #$ ###$# $$ $$##
  #        #   $$   $ ##
  ##   ##### $    $$ $ #
   #####   #  $ $ # $  #
           ###  ###   ##
             #### ##  # 
                   #### 
