################
#       #      #
# *$$   #@* *  #
#   ## ### ##* #
# **#       #  #
#   #   #   #  #
# **#########* #
#   #..     *  #
### * * * *    #
  ##############
