#########################
#.# @#  #  #  #  #  #   #
#.#**.. # $   # $   # $ #
#.#. #.$#  # $#  # $#   #
#.#.$#. # $#  # $#  # $##
#.#. #.$#  # $#  # $#  # 
#.#.$#. # $#  # $#  # $# 
#.#. #.$#  # $#  # $#  # 
#.#.$#. # $#  # $#  # $# 
#.#. #.$#  # $#  # $#  # 
#.#.$#. # $#  # $#  # $# 
#.#. #.$#  # $#  # $#  # 
#.#.$#. # $#  # $#  # $# 
#... #.$   # $   # $   # 
#... #  #  #  #  #  #  # 
######################## 
