   #####           
   #   ##          
 ###  $ ##    #####
 # $$    ##  ##   #
 # #  #$  ####  $ #
 # ##$$ #$ #  $#  #
 # ##    $     $$ #
## ### $  $## ##  #
#  #..### @$ $    #
# #......#  #    ##
# #......  $#  ### 
#  ..##..# $  ##   
###     .# $  #    
  # # #      ##    
  #   ########     
  #####            
