          ######### 
          #       ##
         ## #####  #
   ####### $ ....# #
####  #  #   ....# #
#  #  $ $ ####.#.# #
# $$$ #     ##...# #
#  #   # #  #....# #
##   #    $##....$ #
#  $## $#   #   # ##
# $   @ #$#$ # ## # 
#####  $#       $ # 
  # $ #  # $#  ##$# 
  #    # # $ ## $ # 
  ##  $    # ##   # 
   ##   ##   ###  # 
    ########## #  # 
               #### 
