#######
#  *  #
#  *@ #
# $.$ #
#$ .$$#
#  *  #
# $.$ #
#..*..#
#######
