######### 
#...## @# 
#.*.  $ # 
#  $#  ## 
### ##$###
#   $    #
#  $## # #
#    $  .#
##########
