 ######### 
 #   @   # 
 # $ $ $ # 
###$#$#$ ##
#  $ $ $  #
#  $ # ## #
## # #... #
 # # #.#..#
 #    ....#
 ######  ##
      #### 
