      #     #     #     #      
     # #   # #   # #   # #     
    #   # #   # #   # # @ #    
   #  *  #  *  #  *  #  *  #   
   # *.* # *.* # *.* # *** #   
   # .$. * .$. * .$. * * * #   
  # #   # #   #$#   ###   # #  
 #   # #   # #   # #...# #   # 
# $ $ # $ $ # $ $ #..$..#  $  #
#  $  *  $  #  $  #.$$$.# $$$ #
# $ $ # $ $ # $ $ #.$.$.# $ $ #
 #   # #   # #   # #...# .   # 
  # *   # #   # #   *.*  $# #  
   # $.$ *  *  *  *  #  *  #   
   # .*. # *.* # *.* # *** #   
   # * * # .$. # .$. # .$. #   
    #   # #   # #   # #   #    
     # #   # #   # #   # #     
      #     #     #     #      
