         ####    #####     
 ####    #  ######   #     
 #  #   ##        $  #     
##  #####  ## # # # ##     
#           ####### #      
#   ####$## ###   # ####   
# # #..... $  #     $  #   
#    .*.*.## $## ##  #@#   
# # ####..##   # ## #######
# #    #***..# #  # $  $  #
#    # #.....#    # $  $  #
###    ####$#  #####$$ $  #
  ##   # #  #     #   $$  #
   ##### #     #$ # $    ##
         #  ####  ##  #### 
         ####  ########    
