          #####   
     #### #   #   
     #  ###$# #   
     #  ..    #   
  ####  #####.#   
  #  # $..  #.####
  # $#  ## $#.#  #
  #   ####$..    #
  ##    ...##    #
###  $$@$# #   $ #
#      #   #     #
# # $#$###########
# $    #          
#####  #          
    ####          
