     #### 
  ####  # 
###   $ # 
# $ $#  # 
#    # ## 
###$## ###
 # ...   #
 # .*.*$@#
 ####    #
    ######
