      ##### 
     ## . ##
 ##### $.$ #
##@$.......#
# $$## $.$ #
#  $  # . ##
# $   ##### 
## $$ #     
 #   ##     
 #####      
