   #######   
   #  #  #   
  ##.$#$.#   
###   #  ####
# . $ . $ . #
# $   #   $ #
####.###.####
# $   #   $ #
# . $ . $ . #
####  #  ####
   #.$#$.#   
   #  #@ #   
   #######   
