           #### 
  ##########  # 
  #          $# 
  # ### ####$ # 
###$#......# $# 
#    ......   ##
# $  ##..###   #
## ##  #.###   #
#     $#.#  #$ #
#   #  # $ $#  #
####  $#$ @  ###
  #  $ #  $ $ # 
  # $  $  #   # 
  ####   ###### 
     #####      
