  #####    
  #   #    
  # $@#####
  # $.#   #
####...$$ #
#  .$.$.  #
# $$... ###
#   #.$ #  
##### $$#  
    #   #  
    #####  
