           ####     
           #  #     
         ### $##### 
#####    #    ##  ##
#   ######$ $$## $ #
#        #  #  $   #
## ##### $ @$   $# #
 # #### $$$   $ $  #
 # ###  # #####   ##
## ###    ######### 
#  ##...# ####      
#   ..#.     #      
#  #.... #   #      
####....######      
   ######           
