               #               
              ###              
             ##@##             
            ## * ##            
           ## * * ##           
          ## * * * ##          
         ## * * * * ##         
        ## * * * * * ##        
       ## * * * * * * ##       
      ## * * * * * * * ##      
     ## * * * * * * * * ##     
    ## * * * * * * * * * ##    
   ## * * * * * * * * * * ##   
  ## .         $         * ##  
 ## *                     * ## 
###############################
