       #####   
   #####...#   
   #    ...### 
   #   #...  # 
   ## #....#$##
    # #...#   #
 #### # #   $ #
##  #     $  ##
#  $##  ##  ## 
# $ $ # $ ###  
#    $ $  $ #  
## $   # $# #  
 ##  $ $    #  
  ###  $ $ ##  
    ## @ ###   
     #####     
