       #       
      ###      
     # @##     
    ## $  #    
   #  $.$  #   
  #  $.*.$ ##  
 ## $.*.*.$  # 
## $.*.*.*.$ ##
 #  $.*.*.$ ## 
  ## $.*.$  #  
   #  $.$  #   
    #  $ ##    
     ##  #     
      ###      
       #       
