    #####    
    # @ #    
  ###$.$###  
  # $.$.$ #  
### .$.$. ###
# $.$.$.$.$ #
#   . .     #
#############
