#############   
#      ##...##  
# $$$$$  ....## 
#    $ # #....# 
####   $ ##...# 
  # $#   @ #..##
  #    $ # #   #
 ## $$$###     #
 #  # $ ##  #  #
 #$#    ##     #
##     ##  #  ##
# $ ## ##     # 
# #     $ #   # 
#      ######## 
########        
