##############
#  #     #   #
# $  $#  $ $@#
#  #  $  # ###
# ## ####  #  
# # ....## ###
# # *.*.*    #
# #######  $ #
#          ###
############  
