     #########   
     #       #   
     # #$$$# #   
#######  $   #   
#   ##  $   ##   
# #  ## #########
# $  #. .. # #@ #
# $$ #.....   # #
# $ $#..#..#$ $ #
# #    ....# $$ #
#  # #... .#  $ #
######### ##  # #
   ##   $  ##   #
   #   $  #######
   # #$$$# #     
   #       #     
   #########     
