 ##### ####  ######
 #.. # #   ###    #
 # . # # $  ##   ##
 #.. # ## $   # $ #
 #.. #  ## $  # $ #
###. #### #$ ##$  #
#..  ##  #   $ $  #
###*### $##$    ###
# .   $ @    #$##  
#  $########$# $ # 
#... #   #   # $  #
#. ..#   # $ #  $ #
###..#   #   #    #
  ####   ##########
