     #####     
  ####   ####  
 ##    $    ## 
 #  $ #$# $  # 
 # #$# @ #$# # 
## #  .*.  # ##
#  ...###...  #
# $ ##   ## $ #
###    #    ###
  ###########  
