#############
# .*.* $ $  #
# *.*.$ $   #
# .*.* $ $  #
# *.*.$ $   #
# .*.* $ $  #
# *.*.$ $   #
# .*.* $ $  #
# *.*.$ $   #
# .*.* $ $  #
#@*.*.$ $   #
#############
