        ############       
        #     @    # ######
        # $$$      # #    #
        # .*..   $$# #    #
        #$$ $$$ $$ # ######
        # $   $    # #    #
        # $ $*.$$$ # #  * #
        #  $$.* $  # # ** #
        #     $ $$ # #  * #
        #$$$  $ *. # #    #
        #  $ $$ *  # ######
        #   $*. .$ #       
        # ** *.$ $ #       
        #** ..** $*#       
####### #  .*..* ..#       
#     # #...***. **#       
####### # **.....**#       
#     # # **.***...#       
####### #.... *....#       
        ############       
