         #######################
       ###   #  #    ##        #
 ####### $   # $ $   #  # #  # #
 #  ##   ##$##  #    #   $     #
 #  $    #..$ *##   ## $     # #
 #  # # ##..... # #####$$### # #
##$ $ #   #..#.*..     $    $  #
#   # $ #  #..*.#.##########   #
# $ $ # # $$.#..#.##  ###  #####
##  $ $ #  #..*#..   $   $ #    
 #  $ # ##$#.*...*.#  ## $ ##   
 ###$$#$   #..#.##.##  # #  #   
   # $ $$# #...*.*.$ $ #    ### 
   #      $ #.*..#$##  # $#   # 
   ## # # # ##  ## $ ##     # # 
    # $ $ $ ##       ## #     # 
    ##### @ ###########   ##### 
        #####         #####     
