################
#      ###     #
#     ##   #   #
#  #     @     #
#    #     ##  #
######**###  ###
#    #....*  # #
# $$ #*...#  # #
# $ $#...*#  $ #
# $  *.*..#  # #
# $ $####*##   #
#  $ #      ####
# $  # $$  $   #
#   ##   # #   #
################
