  #####        
  #...#        
 ##...#        
##....###      
# ....@ ###### 
#   # $ #    # 
##.   #    $ # 
 ## ####$#$ ###
  # ## $  $   #
 ## #   $   $ #
 #  # # #$ #$##
 # $$$$    # # 
 #  #   # $  # 
 ########  ### 
        ####   
