    #### 
#####  ##
#  . .  #
# #$@.# #
#  $ $  #
##  #####
 ####    
