 ###########
##   .#.   #
# $$$.#.$$ #
#  $ .#.$  #
#  # .@.$# #
## $ .#. $ #
 ###########
