 ############# 
##   #   #   ##
#  $.. $ ..$  #
# $#*.$#$.*#$ #
#  $.. $ ..$  #
###  *.@.*  ###
  # $#*.*#$ #  
  #  $ . $  #  
  ##  ###  ##  
   #### ####   
