    #####    
#####   #    
#   .$.$#####
#@$ * * $.$ #
##### .  .  #
    #   #####
    #####    
