    ####           
 ####  #           
 #  $  ##########  
 # #$  $    $   ###
 #  $  $#     $   #
##  $  $  ####  $ #
#  #######   ### ##
#   .......# ### # 
## #.......  ### # 
 #  #####..##### ##
 ##$$ $ #..#   #  #
 ##  $  #..# $  $ #
 #     $#..## ##  #
 # @$$$ #..## #####
 ##  $ $ # ##  #   
  ##      $  $ #   
   ######   #  #   
        ########   
