#############
#... #  #   #
# #    ## # #
#    #      #
## # # # # ##
##   # # $ ##
#   ## ## $ #
# #      $# #
#   ## ##  @#
#############
