              ####
###############  #
#     $   $   $  #
#   $   $   $ #  #
## ############ ##
 #.*...........*.#
 ##$########### ##
 #  # $   $   $  #
 #  $   $   $    #
 #  ########### @#
 ####         ####
