   ####   
   #  #   
 ###  ### 
 #  ..  # 
 # $**$ # 
 ###  ### 
   #  #   
   #  #   
  ###*##  
 ##....## 
## $$$$ ##
#    @   #
##########
