  ####       
  #  ####### 
 ##        # 
##  ### # $##
# ... # $ $ #
# .#. ##$ $ #
# ... #   $ #
#     # $@$ #
#    ##     #
#############
