 #####        
##   ######## 
#       #   # 
# @  #$ $ $ # 
# ##$   ### # 
# #   ##... # 
# # $$....### 
# #  ##.....##
#  #$###.... #
##   #       #
 #### $$$$$$##
   #    $   # 
   #   $$ ### 
   ###    #   
     ######   
