##############################
#               #           @#
#  $### # ####  # $   #$ # # #
# #             $$$   $  #   #
# # ###$#$#$$$$ # $   $   #$ #
# # ###        $# $ $ #$  $  #
# # ##########  #   #   $ $  #
# # #.......##$ ###### ####$##
# # #........# $ $ $ $ ####  #
#  $$....#...#         ####  #
### #.....#..###$##########  #
  # #  #..#..###  #         ##
  # #  #.....###  # ######### 
  # #  .....####  # #         
  # #  #########  # #         
  # $    $        # #         
 ## #####$###### ## #         
 # $ $ $ $ $ $ $ $  #         
 #                  #         
 ####################         
