          ####    
     ######  ##   
     #   $....#   
     # #$#...##   
 #####   $..##    
 #     # ####     
 # #$# #   ###    
 # $   ....  ##   
 #$#$# ##.# $ ####
 # $ $  $.#   $  #
## # ####### ### #
#     $  $   $ # #
# @##  #   #     #
#  ###############
####              
