##########
#.*...#  #
#.#$ $   #
#.# $#$# #
#.#    $@#
#. $   $ #
#. $ $  ##
#####  ## 
    #  #  
    ####  
