##################
#        *.##  # #
# # ######..*    #
#   #    ..*.# # #
##$## # #.*#.#   #
#     $ #*.#.#####
# #$##  #....  $ #
#    ####  #  $  #
#       ######   #
##$###$$   $ ##$##
#   $ $  # $   $ #
#   #    ##   # @#
##################
