     #####   
   ###   #   
   #  $  #   
#### $  #####
#    ## $   #
# $ $#  $   #
##$  $ ###$##
 #  ##   # # 
 #$ ## $ # # 
 #   #  #  # 
 #$  ##.@  # 
 #  #...#$## 
 #$ ....#  # 
 #  #....  # 
 ####..##  # 
    ######## 
