   ############  
   #  #   #   #  
####$ $   # $ #  
#     ###$    #  
# # $ #....#$### 
#  $$##...# $  # 
#  $   ...#   $##
### $ #....#$   #
  ###  # ### #@ #
    #   $  #   ##
    #  ###   ### 
    #### #####   
