          ####  
###########  ###
#           *  #
# .**********$@#
#           *  #
###########  ###
          ####  
