   #####   
 ###   ### 
##   #$$ ##
#  ##  #  #
# $#...#$ #
#   ...   #
## $#.#$ ##
 ##  $  ## 
  ## @ ##  
   #####   
