     #####    
     # @ ##   
###### $  #   
# $    ##$####
#   #.*.*.   #
##$$#.....#$ #
 #    ##$ $  #
 ####    #####
    ######    
