################################
#                             ##
# ########### ## ############  #
#               #            # #
##  #  #  ##  # #### # #####   #
#    # # #  # #       #     # ##
#  #   # #  # # ##        # #  #
#  # ### #     #   ##   #   #  #
#  # #    # #  # #    #  #     #
## # # ###  .#$     ##   #  #  #
#  #       ##   # #         #  #
## # #   #    # @  # #  #  #  ##
## #   #    #   #      #    #  #
#  # #    #    ##  #  # ##  #  #
#     #  #    #  #  #       #  #
#  #        #      #        #  #
#   #  ###### ### # ######### ##
#                              #
# ##    #    #    #     #      #
################################
