################################
#     ##    ##  #    ##     #  #
#        #@$       #      #    #
#  #  # #   # ## # # # ## ## # #
## ##     #          #    #  # #
## #   # ##  # # #     #     # #
#    # #   #      ###   ## #   #
# #    # #   ##       #    #   #
#  # #   #    # ## ## ###   # ##
##     # # ##             # #  #
## ## #     ## ## #   # #      #
#        #          #    # ### #
#    ## ### ## #  ####       # #
#  #        #          ### #   #
#    #   #    ### ## # #     # #
# ## # ##  ## #          # #   #
# #              ## # ##    ## #
#     ##  #   #          #    .#
################################
