 #####   
##   ####
# .$. . #
# $.$.$ #
# .$.$.@#
# $.$ $ #
##   ####
 #####   
