       #########   
      ##   #   ### 
####### $$   $   ##
#   #   $  ##$##  #
#        $ ##..   #
## ##  ####....#  #
 # ####   #....   #
 #      $ #..##   #
 #  ## #$##   $ $ #
 #### $ @$   ###  #
    #    #  ## ####
    #########      
