 ########       
##      # ##### 
#  #### ###   ##
#   #  ...#    #
#   #$#...   # #
#     ... #    #
#   ##... ##   #
#########@######
  #   $   #     
  #  $ $  #     
  # $ $ $ #     
  #  $ $  #     
  # $ $ $ #     
  ######  #     
       ####     
