   #####      
   #   #      
   #$$ #      
####.*.#######
#  .  *   .$ #
# $* $..$ *$ #
# $.   *@ .  #
#######.*.####
      # $$#   
      #   #   
      #####   
