 ######
 #....#
## #  #
# @$  #
# #$$ #
# $ # #
###   #
  #####
