     #####     
    ##   ##    
    # $ $ #    
   ##$   $##   
  ## $ @ $ ##  
  #  $   $  #  
 ## # $ $ # ## 
##   ## ##   ##
#    #...#    #
#   #.....#   #
##  $..#..$  ##
 #  #     #  # 
 ####  #  #### 
    #######    
