     #####      
     #   ###### 
     #     #  ##
     ## ## $$  #
     ##...#    #
    ##...*#   ##
 ####..#..##$## 
 #  #*.*.*#  #  
 # $$..#..  $## 
 #  #  #  #   # 
 ##  ###### $$##
##  $  ### @   #
#    $$ # $  # #
# $  #  #$  $  #
##     # $  ####
 #### ##   ##   
    #    ###    
    ######      
