###############
#  .........  #
# $$$$$$$$$.$ #
# $.......$.$ #
# $.$$$$$.$.$ #
# $.$...$.$.$ #
# $.$.$*$.$.$@#
# $.$.$...$.$ #
# $.$.$$$$$.$ #
# $.$.......$ #
# $.$$$$$$$$$ #
#  .........  #
###############
