    ######
#####@#  #
#  $   $ #
# $ $ $  #
#  $#$ $ #
##  *.*#.#
# $ #*...#
#   #....#
##########
