###### 
#    ##
#$$*  #
#..@..#
#  *$$#
##    #
 ######
