#############
#   #   *   #
#**@$ # # # #
#  ## # * # #
#  #    #   #
## * ##*##*##
#  #     #  #
#*##*### .  #
# *      # ##
# # # #**   #
#       #   #
#############
