    ####   ####  
 ####  #####  #  
 #  #$   .....#  
 # $   # ..#..#  
 #  #  ##.###.## 
##$  ####..#.. # 
#   $  @#..... # 
#  $  $$#  ##### 
###$#    ##  ##  
 #   #$ $  $  ###
 # $    #       #
 #####$  # #  # #
   #     # $$ $ #
   # # $ $   ####
   #  $$ #####   
   ####  #       
      ####       
