    ####       
 ####  #####   
 #  $  $   ### 
##$    ### $ # 
#    $###    # 
#     # $ $ ###
##  ##  #  @  #
 #..#..  # #  #
 #..#..    $$##
 #.....##    # 
 #...## $$#### 
 #### $    ##  
    # #$    #  
    #   #$# #  
    # $  $  #  
    ####   ##  
       #####   
