   ####   
####  ### 
#       # 
# ##.$# # 
#   *.$ ##
## ..*.. #
 #$#$*## #
 #   $@$ #
 ##   ####
  #####   
