               #####  
              ## @ #  
              # $$$###
       ########  #   #
       #  #...#      #
       #.  .  $$$#  ##
  ######..#..##    ## 
 ##    ##.$$ .######  
## $#  $  #  .#       
#    $$#.    .#       
#   #  ########       
### $$ #              
  #   ##              
  #####               
