 ####    ####     
 #  ######  #     
 #          #     
 #  # $ $$ $#     
 ## #### #  ####  
  #.##.. # $   #  
  #...  ##   $ #  
  #.##$ @ ###  #  
###.##  #  # $ ###
#   ...    #   $ #
# # ###    # $#$ #
#   # ##  #      #
#####  ####   #  #
          ########
