 #######
##  #  #
#  *$. #
#  * * #
#  ** @#
#  * * #
#  * * #
##  #  #
 #######
