    ####         
 ####  ###       
 #   $ $ ###     
 # #$ $  $ ####  
 #    $     $ ###
 ### ## $ # # $ #
 # $ $ ## $     #
 # $     ## $   #
 # #### @$ # $  #
## .... $$ ## $ #
#  ....##.    ###
#  .#.....#####  
## ....####      
 #  ####         
 ####            
