################
#.#...#        #
#.#..$ $$##### #
#.#...#      # #
#.#...# $$$$$  #
#.#..$##  $  # #
# $$ $@#     # #
# #  $###$$$$# #
#              #
################
