     #####      
   ###   ##     
  ## $$   ###   
###       $ ####
# $$####.##    #
# $ ........$  #
#  $###.....# ##
##  $ $ # ### # 
 ## #@$$$   $ # 
  #     #   ### 
  #######  ##   
        ####    
