       ######  
       #    #  
 ##### # $$ ## 
 #   ####$   # 
 # $ # $  @$ # 
 #  $   # $$ # 
 ##  #$#   ### 
 #     #  $ ###
## ### #$#  $ #
#  #......#   #
#  ..**...#   #
#  #..####    #
####.*  $     #
   #  #####   #
   ####   #####
