  ###########
###         #
#   ######  #
#  @#.....  #
# $.....##  #
#  ### #  $ #
# #    $ #  #
#  $$$ $  ###
### #  $$  # 
  #   #  $ # 
  ######   # 
       ##### 
