  ########### #####    
  #    ##   ### @ ###  
  #  # $  #     $   #  
 ##$ $ $ #######$## #  
 #  $  $##     # ## #  
## $ $# #  # $ # ## #  
# $ $   # #### # ##$###
#     $##$# #....# $  #
####$  $  ###....     #
   #   ## $.*..#*#    #
   ####   $ #.....##  #
      #  $# #.....##  #
      # $   #..#..##  #
      ### $ #####.##  #
        ## ##  ## #####
        #     $## ##   
        #   # $ #  #   
        #####      #   
            #  #  ##   
            #######    
