    ####    
   ##. #### 
 ###..    # 
## ...# $ # 
#  ...    # 
#  ..# #### 
#  .# @   # 
# $  $ #$ # 
#####$#  ###
 #    $    #
## #$ #  # #
# $    ##  #
#   #    $##
## ## $    #
 # ##### $ #
 #  ##   $##
 ##       # 
  ######### 
