########
#.    .#
# *$$#$#
#  ..$ #
# $..$ #
#$#$@* #
#.    .#
########
