   ####    
   #  ###  
####$   ###
# $   # $ #
#@# #$#.# #
# #.....  #
# $.#$#$  #
###      ##
  ##   ### 
   #####   
