########
#    #.#
# #$ * #
# $  #@#
# ##$# #
#.    .#
########
