     #####     
     #   #     
  #### $$####  
  # $     $ #  
  # #### ## #  
### #.....# ###
# $ #   . $ $ #
# $ # #.# # $@#
#     .#  #   #
### #.....# ###
  # ## ####$#  
  # $       #  
  #### $$####  
     #   #     
     #####     
