#####                
#    ###             
# $$$   ###          
#@   $$$   ###       
####    $$$   ###    
    ###    $$$...####
       ###    ***...#
          ### ...**$#
             ###....#
                #####
