################################
#       #    #     #     #    .#
# ## ##   #      #    #     #@ #
# # # # #    # #   # #    # ## #
# # # # # ##   # ##     #      #
# #   #       #     # # #   #  #
# #   #   ###     # #    #   # #
#      # #   #  # #    #       #
#  ##    ##### #        #  #  ##
##   # # #   #    #####   # #  #
#        #   # #     #         #
#  #  #        # #  #   # # # ##
#     # ##  # #    #           #
# # #     #       #####  ##### #
#    # ##   #  ##      # #     #
### #     #  # #    #    ####  #
#       #        #    #  #     #
# $ # #    #  #  # #     ##### #
#   #    #   #       # #       #
################################
