#######
#. $ .#
#.$$$@#
#. $ .#
#######
