   ######          
   #    #      ####
  ## ## ########  #
###...#  ##  # $$ #
# .....  # $    $ #
# # . #  #   #$ $ #
# ##.## # $$ $    #
# #.. # #$ # # #  #
# $   @$     #   ##
###  ######  ##### 
  ####    ####     
