#######
# .$. #
#  $  #
# *** #
#. * .#
# $*$ #
#  *  #
#@ *  #
#######
