      #####     
#######   #     
#   ##.   #     
#  $#..  ###    
## ....#$$ #####
 # $.#.$       #
 # $###$##$# $ #
 #   #     $$# #
 ##*$# ##$#$   #
 #... $@ $   ###
 #.*.#$#   ###  
 #...  #####    
 #######        
