   ##########     
   #   #    ######
#### # $$#  #    #
#... .#  #  #  $ #
# #.#.# $  #   $ #
#.....#$# $  $#  #
#.#.     #$#$$   #
#. ...#$$$  $ $# #
##@ ## $ #  #    #
 #     #    ######
 ############     
