          #####     
          #   ###   
  #####   #     ####
  #   ######    #  #
  #     #  ###*#   #
 ###    #   *  #   #
 #  ##*##  ##@ .$ ##
##  *  ##  ##*##  # 
#   #  . $ #    ### 
#   #*###  #     #  
#  #    ######   #  
####     #   #####  
   ###   #          
     #####          
