   ###                  
 ###.#      ########    
##  $#####  #      #    
#  $ ....#  # $ ## #    
#  #####.### $  #   ####
#  ###...# $ $ # $#$   #
## ###...# # ## $      #
## $  .... $ #  $ $ ## #
#  #$#.  #   $ ####$#  #
## # #...##    $     $ #
# $# ######@####$## #  #
#   ...#  #    # ## #  #
#  #.  #  ### $   ### # 
# $#####     ## $     # 
#  #          #$ ###### 
####          #  #      
              ####      
