###########
#    @    #
# # # # # #
# $ $ $ $ #
# $ $ $ $ #
#$.#####*$#
#.........#
###########
