###############
#             #
# * * * * * * #
#  * * * * *  #
# * * * * * * #
#  * * * * *  #
# * * * * * * #
#  * *$+ * *  #
# * * * * * * #
#  * * * * *  #
# * * * * * * #
#  * * * * *  #
# * * * * * * #
#             #
###############
