           ####    
       #####  ###  
       #        ###
  ###### $ $  $ $ #
  #     # $ $ $$  #
  # ### ##### $ $##
  # ##....  #    # 
  # #....#   #$  # 
  #  ...... $#  ## 
 ####..#...  #$ #  
 #   #....# $   #  
## #  ## #####$ #  
# $$            #  
# $  # $ $ $ $$@#  
#   ##########  #  
#####        ####  
