        ####                    
    #####  ###         ######## 
    #   #  $ #   #######  ##  # 
    # $    $ #####  #  # $  $ # 
    ## # ##      #$    $  ##  # 
    #  #..*    ##  ##  #     ###
    ##.#*######  #  # #   ## $ #
    # ...........*  #  # #     #
    # $ #  ###  ##  #  ## # $$ #
#######$## #   #..### #   #  ###
#   #     # #  # *....#  # ###  
#   $    #  ## # .## .#  $ #    
##$# # #@# $  #...#  # #   #    
 #  #   #   #  ##*.## $ $  #    
 ##   $ ##  #$$     #    $ #    
  # $$       $ ##  # # #####    
  ###  #  #  # #  #  #  #       
    ########   #     $  #       
           ######  #   ##       
                ########        
