  #####  
  #   #  
### $$###
# $...  #
# $...$ #
#  ...$ #
###$$$###
  # @ #  
  #####  
