###################
##   #   #   #   ##
# $ $.$ $ $ $ $ $ #
#  $.*.$ # *.*.*  #
# $.*.*.$@$.*.*.$ #
##.*.*.*.# *.*.* ##
# $.*.*.$ $.*.*.$ #
#  $.*.$ # *.*.*  #
# $ $.$ $ $ $ $ $ #
##   #   #   #   ##
###################
