####    #####  
#  ######   #  
# * ##   *# #  
# *    #  * #  
# * ##### # #  
#  ** * **  ###
#@         $*.#
#  ** * **  ###
# * ##### # #  
# *    #  * #  
# * ##   *# #  
#  ######   #  
####    #####  
