###################
#  # . # . # . #  #
# $#$. #*.$#$.$#$ #
#  # .*  . #..    #
#   $. #$.$  .$#  #
# $# .$# ..#$. #$ #
#  #$. #$.$# .$#  #
# $# .$# . #$. #$ #
#  #$. #$.$# .$#  #
# $# .$# . #$. #$ #
#  #$. #$.$# .$#  #
# $# .$# . #$. #$ #
# $  ..#$.$  .$#  #
#  #..$  . #...   #
# $#$.$#$.$#$.$#$ #
#  # . # .@# . #  #
###################
