#######     #######
##  . ##   ## .  ##
 ##  * ## ## *  ## 
  ##  * ### *  ##  
   ##  *   *  ##   
    ##$ * * $##    
     #   *   #     
    ##$ * * $##    
   ##  * @ *  ##   
  ##  * ### *  ##  
 ##  * ## ## *  ## 
##  . ##   ## .  ##
#######     #######
