      ####      
    ###  #  ####
    #   $####  #
   ##$  $ #    #
  ##  $ #   #$ #
###     # @$   #
#   $##  # # $##
#  #     # $ $ #
## #####   #   #
 # $ #...  #####
 #$  #......#   
 #   $..*.*.#   
 ##  ########   
  ####          
