    #######         #####       
   #  # # ###       #   ##      
  #     $  ###      #$  ##      
 #  $ ##    ###    # $   ##     
#  $ #### $  ##    # #$$ ##     
#   ###  #  $ ##  #  # $$ ##    
# $###    # $ ##  # ##    ##    
#  ##     # $@## #  ### $$ ##   
# $##   ### $ ## # ## #   $##   
#  ##  #  # $ ###  #####$   ##  
# $ # #.....$#### $      $  ##  
# $  ## #..* ###  #######.**.## 
 # $  #$#...#### ##     #...*## 
  # $    *.*.##  ##      #*...##
   # #   #..... ##       #..*..#
    ##############      ########
