  #####  
  # @ #  
### $ ###
#  * *  #
# * * * #
#  * *  #
### * ###
  # . #  
  #####  
