##########
#. $    .#
#.@##*$ .#
# $ *  $ #
#  ##*# .#
##.$  $* #
#####    #
##########
