   ####             ####   
   #  ###         ###  #   
 ###$ $ ## ##### ## $ $### 
##   $  $ ## @ ## $  $   ##
# $ $ $ $ #  $  # $ $ $ $ #
#           # #           #
# $ $ $ $##.# #.##$ $ $ $ #
#### ##  #..# #..#  ## ####
   # #####.......##### #   
   #  $ ##.......## $  #   
   #  # ##..#.#..## #  #   
   #### ##.#   #.## ####   
     #       #       #     
     #  #   ###   #  #     
     ## ## ## ## ## ##     
     #     #   #     #     
     #   ###   ###   #     
     #####       #####     
