#########
#       #
#$$$ $$$#
#.......#
#...#...#
#$$$$$$$#
#   @   #
#########
