 ######      
 #    #      
 # $ $##     
##$# $ ####  
#    $    #  
# $  @ ##$#  
# # # ### ###
# $ # ....  #
###$# ###.  #
  #   ##.   #
 #### ##.   #
 #   $...  ##
 #   ####  # 
 #####  #### 
