         ########
         #   #  #
         #   $  #
      #####$##  #
      #   #  # ##
      #   $  # # 
   #####$##  # # 
   #   #  #### # 
   #   $  # @$ # 
 #### ##  #$## # 
##  # ###   ##$##
# $ # ####      #
#    ....  ##   #
##$#######  #####
#   ......  #    
#   #########    
#####            
