 #####   
 #   ### 
 # # $ # 
##$. . # 
#   # ###
# #. .$ #
#  $ #  #
#### @ ##
   ##### 
