     #########     
    ##       ##    
   ##  ## ##  ##   
  ##  ###   $  ##  
 ##  #### ####  ## 
##  ### $.  ###  ##
#  $### # #$####  #
# # # $. . .  ### #
# # # # # # #$### #
#    . . * . .    #
# ###$# # # # # # #
# ###  . . .$ # # #
#  ####$# # ###$  #
##  ###  .$ ###  ##
 ##  #### ####  ## 
  ##  $   ###  ##  
   ##  ## ##  ##   
    ##   @   ##    
     #########     
