   ######## ########   
   #   #  # #  #   #   
   #     $# # $$  $#   
   #####  # #  $   #   
  ##   $ $# ## ###$##  
 ##    #..## $@$ #..## 
### ####..*....*..*.###
 ##    #.*######$ ..## 
  ##      # #    $###  
   ##### $# #  $#  #   
   #      # # $ $  #   
   #   #  # #   #  #   
   ######## ########   
