 ###########    
 # @ * * * #####
 #$#  * *  #   #
 # # * * *     #
 # #  * *  ## ##
 # # * * * ## # 
 # #  * *  ## # 
 # # * * * ## # 
 # #  * *  ## # 
 # # * . * ## ##
## ##########  #
#              #
#   #########  #
#####       ####
