#####################
#.........    #  #  #
#.........         @#
#.#### ###  ##  ## ##
#.#  # #   #   #  # #
#.#  # #  ##   #  # #
#.#$$  #$# #$#$#  # #
# #  # #   #   #$#  #
# #  # #   #   #    #
# #$$  #$# #$# # ## #
#                #  #
## ### $ ## #### # ##
#     #  $ $ #     ##
## $#$# #$# ####$#$ #
#     $      $      #
###$####$#### ### ###
#                   #
#####################
