################################
##       ######  ###############
#  $ $ $ #          #         @#
#  ##### # $$$ #  $   $ $ $  $ #
##  #### # $ $ # ###############
#   #    #    ## ##########   ##
# $ # $  ######  ##     ### $ ##
#   # $  #  $ $   # $ $ ### $ ##
# $####  #$       #  ###### # ##
#  $  #.....$ $$              ##
#     #..#  *#$ ########  #$# ##
#######.*#...     #    # ## # ##
#      ..#..* $ $ # $$$# ##   ##
# $####..####.##### $ $  ##$  ##
#  $ ##.......#          #     #
##   ##.*### .# $    #####$ $$ #
#######..###### #$$ ##         #
#.............#   $$ # $$$$$$$ #
#.............###    #         #
################################
