     ###########   
     #   ##    ####
    ## #    $$$   #
    #  $$$$$$  $$ #
    #        ##   #
  #####.##$# #    #
  #  #...# # $   ##
  #   ...  ####  # 
  #  #... ##  #### 
 ### #.## #        
## $ #... #        
#      @ ##        
# #  #   #         
#   ######         
#####              
