   #####       
   #   ##      
   #    #####  
#####.#$#   #  
# ...     $ ###
# ##. # $ $   #
# .....#$ #$  #
## $.#@#  #  ##
## #.  # $#$ # 
#  . ###  #  # 
#     #   $$ # 
###   # $ #  # 
  ##  $  ##### 
   ####  #     
      ####     
