  #####  
  #   #  
###$ $###
# $...$ #
#  .*.  #
# $...$ #
### $$###
  # @ #  
  #####  
