  ###  
 # . # 
# $.$ #
#  .$@#
# $.$ #
 # . # 
  ###  
