 #################
##.....#     #   #
#......# $$  $ $ #
#...#####   #$   #
##..$     ###  $ #
#   # ##### @# $ #
#   # $  $ $$ $# #
####  $  $    $  #
   # # ###########
   #   #          
   #####          
