######       
#    ####    
#@ *$*.*#### 
#  . * $   ##
## *****   ##
## $ * . ### 
#  *.*$* #   
#    #   #   
##########   
