     ####           
     #  #######     
     #     ...######
     #  ###....    #
  ##### ##....###  #
  #      #...###  ##
###$##   #..### $  #
# $ $ ####    #$   #
#       #####$#   ##
##  $    ###  #$ ## 
 # $ $ $$$@#$    #  
 #####   $ $  #  #  
     ###      ####  
       ########     
