#############
#           #
# ###$##$## #
# #       # #
# $ #*### # #
# # #...# # #
# $ #.*.* #@#
# # *...# # #
# # ##*## # #
# $       # #
# ##$#$#$## #
#           #
#############
