#####   
#   #   
#  $####
#.*+*  #
# $$*  #
#   .  #
########
