      #### 
#######  # 
#    @$  # 
#   $## $# 
##$#...# # 
 # $.*.# # 
 # #...  ##
 #   # #$ #
 #$  $    #
 #  #######
 ####      
