   #####    
   #   ##   
   #    ##  
 ### $ $ ## 
 #  $ # @ # 
 # $ #.#  # 
 ##  ...$###
####$#*#   #
#    ..#$# #
# $$##..$  #
#    ..#   #
############
