    #####       
  ###   #  #### 
 ##    $####  # 
## $$$   .....# 
# $ $  ######.##
#   $$# @ .#.  #
# $ $ $ #  . $ #
###     # .#.###
  #  ### .## #  
  #### # ##  #  
       #    ##  
       ######   
