#######   
#     #   
#@$$*$#   
#  $..#   
### *.#   
  ##*.####
   #..   #
   #  $$ #
   #     #
   #######
