############################
############################
##                        ##
## $.$.$.$.$.############ ##
## .$.$.$.$.$             ##
## $.$.$.$.$.############ ##
## .$.$.$.$.$             ##
## $.$.$.$.$.############ ##
##                        ##
## ###################### ##
##                        ##
## ###################### ##
##                        ##
## ###################### ##
##@                       ##
############################
############################
