  ######      
  #    #####  
 ##$#  $ $ ###
##  $ # $  $ #
# $  $     $ #
# ## ## $  $ #
# #....###   #
# #....  #$ ##
#  ..#.#$#  # 
####...  $ ## 
   # @   ###  
   #   ###    
   #####      
