         #######           
         #.....#           
         #.....#           
###########. ##############
#   #  #  #. #  #  #  #   #
# # #  #  #. #  #  #  # # #
# # #  #  #.@#  #  #  # # #
# # ## # ##$### ## # ## # #
#  $## # ## $   ## # ##$  #
##  $ $#    $#  $  #$ $  ##
## ##  $ $## # ##$ $  ## ##
#  ## ### ## # ## ### ##  #
#   #  #  #  #  #  #  #   #
##  #  #  #  #  #  #  #   #
#   #  #  #  #  #  #  #   #
###########################
