 ########
 #  .   #
##$$.$$ #
# ..*..@#
# $$.$$##
#   .  # 
######## 
