     ####### 
######  #  # 
# $ $  $# $# 
#  .... #  # 
##.###.$# $# 
#. .##. @  # 
# $ .. $ #$# 
### #.$### # 
## $.$ ### ##
#  .$     $ #
# #  ####   #
#   ##  #####
#####        
