      ############    
      #   #   ##  #   
 #### # # # ..    ### 
 #  ### $ ##..##     #
## $$ ### ##..## ### #
#  $  #  $  ..#      #
#  #  $   ##*##  # # #
# $$$ ### ##..#      #
##   ####$##..#    # #
 # ####   $ ..#  ##@ #
 #  #  $$ ##  #      #
 ##   $ #   ##########
   ##      #          
    ########          
