### ###      
#+###.##     
# $ ...#     
# $    #     
##  $  ##    
 #$$$$$ ##   
 # $ $ $ ####
 #  $ $ #...#
 # $ $  #...#
 # $  $  ...#
 #       ...#
 ############
