 #####         
 #   ######### 
 #     $ #   # 
 ##$#    $   # 
 #  ####### ## 
 #  $.....#  # 
 #  #.....$ $# 
## ###..###  # 
#    #.#   # ##
#@$$$    #    #
#   # $$$   $ #
##  ###    ####
 #### ######   
