#########     
#    #  ##### 
# $$$ $     # 
#   $ $ ## @##
# $$$$$#... .#
# $ $     .#.#
# $ $$$#.....#
#    # #.#.# #
## # # #. ...#
 #   #  # ####
 ######   #   
      #####   
