###                 ####     
#.#     #############  #     
#.#     #              #     
#.#     # ###### ##### ####  
#.#     #        ####  #  ###
#.#     #  ####  ####    $  #
#.######## #  #########  $  #
#.#  $     #  $ ####### ##  #
#.#   # #  #    $ ##### #####
#.##### ##### $     $ # #    
#.#     $ ### ### $   # #    
#.  $ #   $ # ####### # #    
#.          # ####### # ##   
#.#######   # ####### $  #   
#.#     #   #    $    $  #   
#.# ### #   $  ###########   
#.#   $ $ @ $  #             
#.### #######  #             
#.    #     ####             
#######                      
