      ####          
      #  #########  
   ####          #  
 ###  # ### ###  #  
 # $  $   $     ##  
 #    ##  #  # $####
 # ###..#  ##      #
 # ##...#$  $ #$ $ #
## #....# # @   # ##
# .....##  $ # $# # 
# ......# #  $  # ##
###...#.#  # ###   #
  ##### ## #  $  $ #
  #      $ ## $ #  #
  #  #   #####  ####
  # $ ### $ $ $ #   
  # $      $ $  #   
  ## $$ # #    ##   
   ###    ######    
     ######         
