############ 
#          ##
# $ $ ###$$ #
# $##     $ #
# $ $$ $  # #
#    $$#$ # #
#### #@$  # #
#...  #$$   #
#...    $#$ #
#.....#  #  #
#.....# $$$ #
#.....#     #
#############
