##################
#    ##  ##..#   #
#  #$$   ... # $ #
# $#  #####**    #
#   $ ##  # ##$$ #
#  $$$#....$   # #
# $ $@#.*..##  # #
# $ $$#.##. $$ # #
#     #....    # #
##################
