           ####
 ####    ### @#
##  ######  $ #
#    #..#    ##
# $   .*#$#   #
#  ###*.   #$ #
## #  ..##$   #
# $  $..$   # #
#   ##..# #$# #
####### #     #
     # $# #####
     #    #    
     #  ###    
     ####      
