##################
#    ##   #  #  @#
## #  $       $$##
# $   ##$##$##$  #
# ###  #    #    #
#   ##$   # # ## #
# $  # #### #    #
#.#.## #  # #  $ #
#...  $   #   #$##
#... ## #$##$##  #
#...##           #
#... #   #  ##  ##
##################
