       ####  
 #######  #  
 #      $ #  
 #  $ $## ## 
 # #$   $  # 
 #   $ # # # 
 # # $ # # ##
##  # #.   .#
# $   # . . #
# #$#### . ##
#       .#. #
#######. @ .#
      #######
