#####  #####
#   #  #   #
# $ ####$$ #
# $ ....   #
###.#$$#.###
  #.$@ $.#  
  #.$$$$.#  
###.#  #.###
#   .... $ #
# $$#### $ #
#   #  #   #
#####  #####
