      ####     
 ######  ##### 
 #           # 
 #$ #.# ### $##
##  #.# #.#$  #
# $ #.# #.# $ #
# $ #.# #.# $ #
# $ #. @ .# $ #
# $ #.   .# $ #
# $ #.# #.# $ #
# $ #.# #.# $ #
#  $#.# #.#  ##
##$ ### #.# $# 
 #           # 
 #####  ###### 
     ####      
