#########
#   *   #
#.$$*$$ #
# . *. .#
#. .* . #
# $$*$$.#
#@  *   #
#########
