###########
#    @    #
#$$$$#$$$$#
#    #....#
#$ $$#****#
#.*..#....#
#..*.# $  #
#**.*#$ $$#
#    #    #
#  # # #  #
###########
