     #####         
    ##   ####      
  ### $     #      
  # $ # ### ####   
  # ......# #  ### 
  ##*.....# # $  # 
   #..## ##$#  $ # 
   #*.##     $@ $##
   #..##  ## # $  #
 ###*.###### #$$  #
 # $..#   #  # $ ##
 # #$   $ # $    # 
## #  ##$##  #$### 
#  ### $   ### #   
#              #   
#  $     #######   
##   #####         
 #####             
