         ######## 
 #########.     ##
 #  ##  .....    #
## $ $$#.###.#   #
# $ @# # ###.##  #
#  $ $ # ##.  ####
##  $     .   #   
#  $   # ##  ##   
# $$$ ##  ####    
#    ###  #       
###### #  #       
       ####       
