#######
#  *  #
# $*  #
# $.  #
#.***.#
#  .$ #
#  *$ #
#@ *  #
#######
