#######
## . @#
# $ $ #
#. * .#
# $ $ #
## . ##
#######
