 #############  
## ......    ###
# .######  #$  #
#  ...... #    #
##$######$#    #
 #   $    ###$ #
 # ##### @    ##
## $   #$####$ #
#  #$  # $ $   #
#    $ # #   $ #
##   #   #   ###
 #############  
