######################## 
#          #     ##    ##
# $$$ # $$ # $# $#  $$  #
# $   #$  $  $ $   $  $ #
##$$$  $ #$ #$$ ## $@#$ #
#   $ #$  $  $ $   $  $ #
# $$$ # $$# #$  $## $$  #
# # ##  # #    # #   ####
# #  # ##  ####    ###   
# ##    ##    #   ##     
# ...    .. # .# ..####  
##.##.##.##.# .#.#.#  #  
##...   .... #. . .#  ## 
# .# .##.##.  .#.#.    # 
# ...  #.  .# ..##.##. # 
#  ###      #          # 
#### ###  #     #  #   # 
       ################# 
