             #####   
             #   ##  
        ###### $  #  
        #   #  # $###
     #### $ #$      #
######    #    # ## #
#     $$# $ $###* # #
# $### @$ ## #....$ #
#   ### # $  #.#...##
## $   $# #   ....## 
 #  ##    $ #$*...#  
 ##  ###  #$ $.#..#  
  # $#####  # *...#  
  #  #  #  ####...#  
  # $$$    #  #####  
  #  # $ # #         
  ##   # $ #         
   ###    ##         
     ######          
