            #### 
###### #### #  # 
#    ### @###  # 
# $$ $ # $$    # 
#   $#  $ $ #$###
####.### #$ $ $ #
   #.....#  #   #
####..##.##$  ###
#  #.....   ###  
#  ....#$####    
#  ##### #       
##$###   #       
#  ## $  #       
#    $ $##       
#  ##   #        
#########        
