 ######  ##### 
##    # ##   ##
#  $  ###  $  #
# $*$*....$*$ #
#  $  ###  $  #
## . @# #  *  #
 ##.### ###.###
  #.#     #.#  
###.### ###.## 
#  *  # #  . ##
#  $  ###  $  #
# $*$....*$*$ #
#  $  ###  $  #
##   ## #    ##
 #####  ###### 
