 #####  ####                   
 #   ####  #######       ##### 
 #$       $      #########   # 
 #  ###### ##### ##  $ $     # 
##  #    #       #  $   ##$$$##
#   #    #$###$$ # $   ## $   #
# # $ #$#  # $ ### $  #     $ #
#   # #  $ # $ # $ # #  $ $   #
##  #    # # $ #   $ # #$######
 ####  ##  . # # $ $ $ $ ####  
    #  ##  .#  #@##$##      #  
    # #####.#  .*#.. #   #  #  
    # #  ##. ##.*..#$#####  #  
    # # ......#...#        ##  
   ## # .##......#  $$ #   ### 
   #  ## ##.#...#   #  #$#   # 
   #      #....####  ###  $  # 
   ####   #..... $ $ # #$#   # 
      ########  ###  # #    ## 
             #### #### ######  
