  ####      
###  ##     
#   . ######
# $ **.$   #
##  .#   $@#
 ###   #####
   #####    
