               ####        
              #    ##    ##
 #############    $  # ####
#........... #$$  $$$@## ##
#...........*    ## $$ # ##
 ##########$#  $##    $# ##
         #   #  ##   $   ##
         #   #  # ##   # ##
          ##$####   ##$# ##
          # $   #   $  # ##
          #   $## #$   $ ##
           ##   $ $ $ ## ##
           #    #   ## ####
            #########    ##
