########  ########## 
 #    #    ##    ##  
 # $$ #   ##  $ ##   
 #  $ #  ##  $ ##    
 # $$ # ##  $ ##     
 #  $ ###  $ ##      
 # $$ ##  $ ##       
 #  $ #. $ ##        
 # $$ #**.##         
 # @*$..*.##         
 # $$ #..*.##        
 #  $ ##..*.##       
 # $$ ###..*.##      
 #  $ # ##..*.##     
 # $$ #  ##..*.##    
 #  $ #   ##..*.##   
 # $$ #    ##..*.##  
 #    #     ##..*.## 
########   ##########
