  #####   
  #   #   
###   ####
#  ***$  #
#  *..  @#
#  ***$ ##
###   ### 
  #   #   
  #####   
