 ###############    
 #    #   ##   #    
 # $$ # $    $ #    
 ###  # ####$$$#### 
   # #  #  # $    ##
   # # @$  # $$ $  #
   #   $## # $  $  #
####$$  ## #     ###
#  # .#### ######   
#...... . .#        
#.# #*## #.#        
#. . ...  .#        
############        
