  ###########      ########
  #         ########   #  #
 ## #######        # $  $ #
 #    $  #######$#### ##  #
 # $ ###     $        ## ##
 #    $  # #$#$###### ## # 
 ####### # # # ###### ## # 
 #   ### # # # ######  # # 
 # $     $ # $ $       # # 
###$#### # # # #   ### # # 
#        # $ #   ###   # # 
#      # # # ####    ### ##
######## # #      ###  #  #
#  ##### # #######  # $   #
#        $@$        #  #  #
#..################  # ####
# ................     #   
########################   
