#############
#   . @ .   #
# $$* $$* $ #
#.*.*.*.*.*.#
# $ * $ * $ #
# $ * $ * $ #
#.*.*.*.*.*.#
# $ *$$ *$$ #
#   .   .   #
#############
