   ####      
   #  ###### 
   # $   $ # 
   # $ $ $ # 
   #  $ $  # 
 ####    ####
## $  ###   #
#   # ..    #
#@$ #$.. # ##
##$ $ ...# ##
 #  # ...   #
 #### ..#   #
    #########
