##################
#.....##         #
#.....##$#$##$## #
#.....# $   $  # #
#.....# #   # $$ #
#  .  #  # ##  # #
#  @  #$ $ $   # #
#    #   ##  # # #
##  #  $  $ #  # #
 ## # #  $ #   # #
  # # ##$  # # # #
  # #  #   $   # #
  # #   ###  # # #
  # ###$   #$# # #
  # ##  $$$$   # #
  #        ##### #
  #              #
  ################
