####           
#  #######     
# $      #     
#  ##### ######
## @#  # #....#
 #       #.  .#
##$ #  ###.  ##
# $ #$ #  #  # 
# $ #     ## # 
#   #$ #$    # 
#####  #  #  # 
    ########## 
