####           
#  #           
#  ##########  
#    ##     #  
#..#  $ $$# #  
#..  ##   $ ###
#..#  ##$# $  #
#..   # @$ $  #
#..#  # $ $   #
#..   # $ $ ###
#  #  #   ###  
#  #    ###    
#########      
