 ####### 
 #  . @# 
##$$.$$##
# ..*.. #
# $$.$$ #
#   .   #
#########
