          ####        
  #####   #  #######  
  #   #####        #  
  # $ $   $ ####   #  
#####  ## # #   $ ### 
#...  # #     $ # $ ##
#...  # # #$#####$   #
#...# # # #   ##   $ #
#...# # #$# $   $$   #
#.#.. #   ### $  $ $ #
##.... #    #  $ #$$##
 #.... # $  # # $   # 
 #....@###$##$#$$   # 
 #####     # $  # ### 
     #####    #   #   
         ####  #$ #   
            ##   ##   
             #####    
