           #### 
         ###  # 
       ### $  # 
     ### $ $# # 
   ### $ $    # 
   # $ $  #$ $# 
   #   $  $   # 
 ####  ##   $$##
 #  $ ## $   $ #
## ## ## ##    #
#  $...#  # $###
#.#.... @ #  #  
#......#  ####  
#....######     
######          
