 ##### 
 #   # 
##$ $##
# ... #
# $*$ #
# ... #
##$ $##
 # @ # 
 ##### 
