 ############
 # $  . #   #
 #   ** # $ #
 #$  #. # ###
 #  ##.#   # 
##$ ##.# $ ##
#   #..#$#  #
# $ # .  .$ #
# @## ***#  #
# $ # .    ##
#   ######## 
#####        
