#################
#   #           #
# $ # $ $$$$ $  #
# $ ###$    $ $ #
# # $  $$  ####@#
#   # #   ##  ###
###*#   ##     ##
#.*.# ####  #  ##
#...$ $  ##     #
#..###$      #  #
#....*.    #    #
#......$ #     ##
#################
