             # #              
            # # #             
 #########    #    ###     ###
##.*.*.*.##   #    #..#   #..#
#.*.*.*.**##  #    # ..# #.. #
#*.*.*.*..*## #    # $..#..$ #
#.*.*.#..*..##     #$ $...$ $#
#*.*.# #*.*..##    # $ $.$ $ #
########.#.*..##    # $ $ $ # 
# # # ## ## $..##    # $ $ #  
# # # #    # $ .##    #   #   
# # # # #$ ## $ .##    # #    
####### $   ## $  ######$#    
##@ $  $#    ##          #    
 ##  $ $ #######$$$$$$$ ##    
  ##  $                ##     
   ##  $$$$$$$$$$$$$$$ #      
    ##                ##      
     ##################       
