   #####   #### 
 ###   #####  # 
 #   .   #   $##
## ##.##$$ $$  #
#@.....$     $ #
#   ..## # $ # #
###.#.#   ##   #
 ##.#.#   $ ####
 #     #$  $ #  
 #     #  $$ #  
 ########    #  
        ######  
