###########
# ... ... #
# ## # ## #
#    #    #
##$#$#$#$##
#    #    #
##$# # #$##
#    @    #
###########
