         ####  
      ####  #  
    ###  $ $###
  ### $ $#@   #
 ## $ #  $  # #
##  #  # # ## #
#  #    ....# #
# $$$#$#....$ #
#   $   ..#####
###   ##..#    
  #########    
