 #####           
 #   ##          
 # #$ ####       
 #   $#  #       
 #    $ $# ##### 
## ###   ###   # 
#       $    # # 
# $# $ ###   $ # 
#  # #$$ #  #$## 
# ##  $ .#### ###
#  $ ###....#   #
####  @ ....# # #
   #####....    #
       ##########
