       #######            
       #     ######       
  ###### $$ $     #       
  #  ## $  $ #### ####    
### @ #  $   #  # #  #####
#  $$ # $###### # $    $ #
#    ###   #  ##### #  $ #
##$$$#     $ .....#$###  #
 #    $ ###$#.##.. $    ##
 # ####$    #.#...#  #### 
 #  # $   ###.#..##  #    
 #  $  #  ##.....## $#    
 #  #  #####.....##  #    
 #######  ##.######$##    
          #    # $   #    
          #    # #   #    
          #  #   #####    
          ########        
