#########
#   .   #
# #.$.# #
# $ # $ #
### @ ###
  #####  
