  ##### 
  # . # 
 ## * ##
## $.$ #
#  $*  #
#@  * ##
### . # 
  ##### 
