#############
#  #    ##  #
# $$$$   $  #
#      ###$ #
#   ###  #  #
##$# ...*#  #
#  # ....## #
#   #...*##$#
# $ #....$@.#
# # #  ##$###
# $ ###     #
##   $ $  $ #
#      #   ##
#############
