 #####           
 #   #   #####   
 #$ $##  #   #   
##    # ##$ $##  
# $$ $###     #  
# #   ##  # # #  
# $$$  #    #$## 
#   #.....#    # 
## ##.....#$# $# 
 #   .#..##  $ # 
 ## $.#...  $# ##
  ##    # #   $ #
   ### @  ##    #
     ##  ########
      ####       
