###############      
#             ##     
# ##########   ##    
# ###  $ $ $ #  #    
# ###.#      ## #    
# ###.#$####$#  #    
# ###.#        ##    
#.###.#$## #####     
#.###.    $#         
#.###.#$## ######    
#.###.#         #    
#.###.#$$###### #    
#.###.#     @   #    
#.###.#$ $###########
#.###.#  $     $    #
#.###.#$  $ $    $  #
#.   .$  $ $ $ $ ####
#  #  #########  #   
#######       ####   
