##################
#               @#
# # ##  $  ### # #
#  #   $$$ #     #
#  # $ $ $ $  ## #
#  $ ###.####    #
#   $#..*...# #  #
# #$ #......#$ # #
#  $ #....*..$ # #
# $$$...#...#  # #
#  $ #......#  # #
# #$ #......# ## #
#   $####.### $  #
# $$    $ $  $ $ #
#   ###$$$$# $$  #
# #$ $ $ $ # # # #
#                #
##################
