 #####  
##   ###
#  #$$ #
# #  # #
#    # #
#.#    #
#. @####
#####   
