#############################
#  #  # #  #  # #  #        #
#  $                   #### #
## ###### ## ###########  # #
#  #      ## #  #  #  ##  # #
#  #  ### #   $ #*.$  #   # #
## ## #   #  #  #..#  #  ## #
#     # #### #$ #*.#  #  #  #
#  ## #    # #  #..#  #  #  #
## #  ####   #$ #*.#  #  #  #
#  # $   #####   ..#     #  #
#  # #       #  #..#  #  #  #
##$#$## ## # ####### #####  #
#  #   @ # $  #  #         ##
#     #### #$ $  # # # # #  #
#  #         #   #          #
#############################
