   ######     
   #    #     
   #  $ ######
   #  $      #
   ## $ #### #
   # $###  # #
   #     $ # #
####  ###..# #
#   ###....# #
# $$ $ ....$ #
#  $  #..#####
##  $$####    
 #@   #       
 ######       
