##############
#            #
#$.$ $.* *.* #
#.$.$.$ $.$  #
#*.* * $ *.* #
#.$+$.$ $.$  #
#* * $.* *.* #
##############
