 ######################## 
 #   #   #      #       # 
## $ # $   $##$ # $# #$ # 
#  $   $ # $@ $   $   $ # 
#  $#$ $  #$$$$#   $ $# # 
## $ $ $#  $  $ ### $   ##
#   $ $ ###$# $ #  #$#   #
# ####  #     # #  # #   #
# #  #    ####  #    # ###
#    ##### ..... # ##. ## 
## #.#.### ### #   ##.  # 
 # .## .## ..... #......# 
 #.     .# ##.####  #.### 
 #. #   .    .#      .#   
 ####   #   .    #  .##   
    ##################    
