      ########## 
#######  #     ##
# $      @ $#$  #
#   ##   #    $ #
##..##  $#$$#$$ #
 #....   #    $ #
 #..#.  $## $ $ #
 #....#   ###   #
 ########## #####
