########## 
#        ##
# $#$#$#$@#
#. .$...$.#
#. .$...$.#
# $#$#$#$##
#        # 
########## 
