        ####       
 ########  ####### 
 #    $     $    # 
 #   $ ## ## $   # 
 #  $ ### ### $  # 
 # $ ##  .  ## $ # 
 #$ ##  ...  ## $# 
## ##  . * .  ## # 
#  ## . .$. . ## ##
#    ..*$*$*..    #
## ## . .$. . ##  #
 # ##  . * .  ## ##
 #$ ##  ...  ## $# 
 # $ ##  .  ## $ # 
 #  $ ### ### $  # 
 #   $ ## ## $   # 
 #    $     $    # 
 ####### @######## 
       ####        
