################################
#   #     #          #   #   # #
# $ # ##  #  ###   #   ### #   #
##  #            #  ##     # # #
#  ### ### #   #   ##  #       #
#            #   #       # # # #
## # ###  #    #   #  ##  #  # #
##       # ##  # #   ##    #   #
## # #        #         #     ##
## #  ## ###   ###  ##   ##   ##
#     #   #  @   # #   # # ##  #
#  #         #       #         #
##  ## ### ### # # # ###   # # #
#            #  #    #   # ##  #
# #  # # #         #   #      ##
# #  ### ## ### #    ##  # ##  #
#                 #    # # #  ##
# ###### ### ### ##  #     # . #
#                  #   #   #   #
################################
