       #####      
 ####  #   ####   
 #  #### $ $  #   
 #     # $ $# ### 
## #  $ #$    $ # 
#...#    $ @$## ##
#...# #$$$   ##  #
#...#    $  #  # #
##..####### $    #
#...#       #$$  #
#...# #$   ##   ##
#...#    $  #  ## 
### ###$#   ####  
 #   $   #  #     
 #   #   ####     
 #########        
