       #####   
       #   #   
   ##### $ #   
   #  ## $#### 
 ###$    $ $ ##
 # $   ###    #
 #   @#  #### #
##$ $ ........#
# $ #$#....####
# # # ....##   
#  $ ## ###    
# $  #    #    
#   ## $$ #    
###### #  #    
    #  $$ #    
    #  #  #    
    ##   ##    
     #####     
