 ########          
##      #          
# $  $# #          
# $  $  #          
#   ###### ######  
# $  #   ###....#  
# $ $#      ....###
# $ @#   # #....  #
###$ #   # ###..# #
  #   #  #   ##   #
 ##$$  ### #      #
 #         ###   ##
 # $$$ ##  # ##### 
 ##    #####       
  ######           
