########
#  .   #
# $*$$ #
#  ..**#
#**..  #
#@$$*$ #
#   .  #
########
