       ####  
########  #  
#  $    ..#  
#@ $ $ #..#  
#####$##**#  
#      #..###
# $    #..  #
##$#####  # #
#   $  #### #
#   $       #
#####  ######
    ####     
