 ##########
 #..  @   #
 ##.##### #
###.#   # #
#  .#  $# #
# $$    $ #
#  #$  ####
####   #   
   #####   
