#############
#    #      #
# ## # #### #
# # $     # #
# #  #*# $  #
# # ##.## ###
#   *.@.*   #
### ##.## # #
#  $ #*#  # #
# #    $  # #
# #### # ## #
#      #    #
#############
