##################
#...  #          #
#...       #  $$ #
#...  ### ##$##  #
##.#### $ $   #$ #
#.....# $$   $  ##
#.....#  $$ #  $##
#..#..# $ $ #$   #
#.....#  $# #  $ #
#.....# $$ $#$ # #
###.### $   #  $ #
#     #  ## #$$$ #
# #   # $$    #  #
# ## ###  ##  #$ #
#   $   #   # #  #
# $#$#$ #     $$ #
#           ##  @#
##################
