  #####  
 ##   ## 
## .*. ##
# .$ $. #
# * * * #
# .$ $. #
##$.*.$##
 # $ $ # 
 ## @ ## 
  #####  
