         #    ### 
        # ####   #
       #  $ $ $  #
       #   $  $  #
      #   $ $  $# 
 ##### $### ##  # 
#     # ###   $$# 
#     #  $   $  # 
#..#    $$  $ $ # 
#.....# $ $# $ $ #
#..#..#   $ @ $  #
#...## $## ### ## 
#.....#  $ $   #  
#.....#$  $#  ##  
#...##   $   ##   
#..#  ##   ##     
 ##     ###       
