   ######   #####
####    #####   #
#    #  # $ $ # #
# #$$#..*  @  # #
# #  #*.#### $# #
# #$ #..#..#  # #
# #  #*....# $# #
# #$ #...*.#  # #
# #  ####### $# #
# #$          # #
# #  $ $ $ $ $  #
#   #############
#####            
