   ############
  ##  #    #  #
###    $$$  $ #
#    #    # $ #
# #$ #$## $ $ #
#  ..#   # #  #
###...##    @##
  #....#$$$### 
  ##...    #   
   ##..#$ $#   
    ####   #   
       #####   
