 #####           
 #   ##   #####  
 #  $ #####   #  
 # $# ## $    #  
 # $      # $ ## 
 #   # $  #$   # 
 #....## #  $  ##
 ##....# # $ $  #
  ##...# #### $ #
 ####..#$# $ $  #
## $ ..   $ $ $ #
#  ##..# # $ $  #
#    ..#  ##    #
# #$@..   #######
#      ####      
########         
