  ######   #########
 ##    ### #   #   #
 # $$    ###   $   #
 #   $ #   ## ### ##
 # #  $## $  $ #   #
## # $  $  #   #$$ #
# $###  #  ####  $ #
# $ $   #####   #  #
# # #  ##..## $  $ #
#    ##....###$#$  #
#      ......#   ###
#     ##......  $#  
###########..##  #  
          #####@ #  
              ####  
