#########
#       #
# $ $ $ #
#  $ $  #
# $ $ $ #
#  $ $  #
# $ $ $ #
## $ $ ##
 ## $ ## 
  ## ##  
 ##   ## 
##     ##
#       #
#   @   #
#   .   #
#  ...  #
# ..... #
#.......#
#########
