           ############
           #          #
 ########  # #$#$#$## #
 #  #.  #  # # #    $ #
## .   .#### $   $### #
#.. #. #. .  #$ $   $ #
#.  .# .. .# $  $ $ # #
##     .  .# # # #  $ #
 ## .##   .# $    # ###
  ####### ## ##$#$#$#  
        #           #  
        #@ ##########  
        ####           
