 #######      
 #     #######
 # ###  @    #
 # #  $#$### #
 # #$    $ # #
 # $ .#..  # #
## # ...#$#  #
#  #$#... # ##
# #  ..#. $ # 
# # $    $# # 
# ###$#$  # # 
#       ### # 
#######     # 
      ####### 
