           #####  
   #########   #  
   #           #  
   ##$#######  #  
 ####+####### ####
 #   *   #   *   #
 #  * *  #  * *  #
 # * $ * # * * * #
 #*  .  *#* *#* *#
 # *   * # * * * #
 #  * *  #  * *  #
 #   *   ##  *  ##
##### ####### ### 
#   # #  *  #   # 
#      * *  # # # 
#######  * *    # 
      #  *  ##### 
      #######     
