  ###########
 ##     #   #
 #   ** # $ #
 #   #. # ###
 #  ##.#   # 
##  ##.# $ ##
#   # .#$#  #
# @ # *   $ #
#  ## .*$#  #
#   ##     ##
#   ######## 
#####        
