   #####################  
####         #         #  
#  $$$#$$$  $  $$$#$$$ #  
#  $    $ #$ $ $@$  $  #  
# #$$$# $  $ $ $$$# $  #  
#    $  $ #$$$ $ $  $ ##  
# #$$$# $  $ $ $  $ $ #   
# # # #   ## ### #  # ####
#......## #...#  ###  .  #
##  ##.## . # . #### #.# #
##  #. # . .##.#..... .. #
#  #.    # #..  .....#.#.#
#  . . # # #.   ### # .# #
##.# #.    .  #       .# #
#.     .##.#  ####### .  #
###############     ######
