###########
#... . ...#
# $ $.$ $ #
#####.#####
#  $...$  #
#  $   #  #
# $$#@$$$ #
#         #
###########
