        #########
  ####  #   #   #
 ##  #### $   $ #
 #  $      ### ##
 #    ########  #
 #  ##.  ##  #$ #
 # # ....    #  #
 # # ##.#$#  # ##
## # .... # ##  #
#   #@$. ##  #$ #
# $  ## .    #  #
## $  # ###  # ##
 ## $      ##   #
  ##  # $ $     #
   ###########  #
             ####
