                  #   #   #    
                 # # # # #.#   
                #   #   #...#  
                #   * $ #.*.#  
               # *$# * * #.* # 
              #   *   #   *   #
  #   #   #   #   #  $#   #   #
 # # # # # # # #$# #$* #$# * # 
#   #   #   #   *   *   *   #  
#   *   *   *   #   #   #   #  
 # *$# #$# # * # # # # # # #   
  # $ #   # $ #   #   #   #    
  # @ # $ #   #                
 #.*$# * # #$# #               
#.*.*   *   *   #              
#*..#   #   #   #              
 #.# # # # # # #               
  #   #   #   #                
