     #####  
     #   ## 
   ### #$ ##
####...# $ #
# $ ...    #
#@$ #..#####
# $ $ ##    
###$$ #     
  #   #     
  #####     
