#######             
##    ###           
# $#    #           
#       #           
#...## #############
##..#  $  $  $  $  #
#...# $  $  $  $  @#
#..##   $  $  $  $ #
#...## #############
# #     #           
#    ## #           
#       #           
#########           
