     #####         
    ##   ##        
    # $ $ ####     
    # $  $#  ##    
    # ##    $ #    
 ####  $  #$  #    
##  #   $ #   #### 
#     ##  #####  # 
#  # $ #$$ #  #$ # 
## # $     $     # 
 # ## #$##.# ######
 # #  $ #....   $ #
 # ##   ...#.###  #
 # #  ######.# #  #
## ###  #.##.# # ##
# $   $ ...#.# # # 
#   ##  #..*.  $ # 
###### @##.####  # 
     #######  #### 
