#########
#       #
# $.$.$ #
# .$.$. #
# $.*.$ #
# .$.$. #
# $.$.$ #
#      @#
#########
