 ####################
 #          #   #   #
 # ######## #       #
 #  $ $ $   ## # # ##
 #         #     # # 
 # # #####$# $ # # # 
 # # #+*.....$ # # # 
 # # ########### # # 
## #               # 
#  # ############# # 
#                  # 
#################  # 
                #### 
