#########
##  @  ##
## $ $ ##
##.*.*.##
## $ $ ##
## $ $ ##
##.*.*.##
## $ $ ##
##.*.*.##
## $ $ ##
## $ $ ##
##.*.*.##
## $ $ ##
##.*.*.##
## $ $ ##
## $ $ ##
##.*.*.##
#########
