####           
#  #           
#  ##########  
# .  ##     #  
#..#    $$# #  
#..  ##   $ ###
#..#  ##$# $  #
#..   # @$ $  #
#..#  # $$$   #
# .   # $ $ ###
#  #  #   ###  
#  #    ###    
#########      
