           #######     
           #     #     
  ########## # $ ######
  #   .   #   $ ###   #
 ## ##.## # $# $    $ #
 #  ..... #  #  #### ##
##  ##.##@  ####   #  #
#   ##.#. # $  # $  $ #
#   .#.#.##     # ##  #
#  #*#*#*## #  $#  ####
###  $   $ $ #  $  #   
  #  #       #  #  #   
  #  ###############   
  ####                 
