 #########    
 #       #####
##$#.###$#   #
# $.... $  $ #
# ##.##.#  $ #
# #. #.$# $  #
#  . @. #   ##
###  # $#  ## 
  # ##  ####  
  # $  $ #    
  #####  #    
      #  #    
      ####    
