#######    
#     #####
# $ $ #   #
##$##..$  #
#  ....#$##
#  #..#   #
# ## # $  #
# $  $   ##
### @ #### 
  #####    
