####################
#.       ##       .#
# #$#$ $ ## #$$$ # #
# $  $$#.##.#  $$$ #
#      ......      #
########.@ .########
########.  .########
#      ......      #
# #$$$ #.##.$#$# $ #
# $  #$$ ## $  #$$ #
#.       ##       .#
####################
