  ###   ###  
 #   # # . # 
# $ $ # $.$ #
#....*@$ .  #
# $ $ # $.$ #
 #   # # . # 
  ###   ###  
