#########
#  .  . #
#.$$**  #
##  .$ ##
 # $$ .# 
 ##@  ## 
  #####  
