   ########             
 ###      ###           
 #   ####   #  #####    
## ##    ## ####   #    
#    .##.    #   $ ##   
#  ##....##  # #$ $ #   
## ##.... # #  $ $ $##  
 # ##..#. # # $ $ $  ## 
 # # ..#.##   $     $ # 
## # ....##  ###$#$## ##
#  ########## $  $     #
#          @    # #    #
#  ######### $ $     ###
####       ### $ $$ ##  
             #    ###   
             ######     
