   ####           
   #  #########   
####$    ##   ####
#     #     $ $  #
# ###.# ##$#$##  #
# #..... #  $ # ##
# # ##.# #   $  # 
# # $..# # $   $# 
# # ..@. # ###  # 
# #.#.#### #  ### 
# # #.##    $ #   
# # #    $#   #   
# # # $ $    ##   
# $  ###  ####    
##   # ####       
 #####            
