    ########    
    #      #    
   ##$##$# ###  
   # $ $ #   ###
  ##  .....$ $ #
  #  .#####*$$ #
  #$#.#   #. $ #
### #.$$$ ##.  #
# $ #.# $  #.###
# # $.# $$ #.#  
# $ #.$    #.#  
# # $.#$#$  .## 
#    .  #  #. # 
### .#######* # 
  ##.#  $ ..  # 
  # .# $$$.#  # 
  #   ..*..# @# 
  #  # $$$ #### 
  ####     #    
     #######    
