     ##### 
######   # 
# . ...$.##
# #$$$ $  #
#  $@$$$# #
##.$... . #
 #   ######
 #####     
