    ################
    #    #   # .   #
    #   @  $ # .   #
#####   # #$###*## #
#   #   #  ....* # #
# $ #######*##   # #
# $ $ #  # *...*.# #
# $ #    # # ##*## #
# $ $$#      ##.   #
# $   $ ###  #######
##  #   # ####      
 ########           
