  ##### 
###   # 
# .  *##
# $** @#
#  .*$ #
##.$ * #
 #   ###
 #####  
