     #######  
    ##  #  #  
   ##  $. $#  
  ##  $.#$ ## 
 ##   .# $  ##
##  @.#  #   #
#   ..# $ $$ #
#  .#.#      #
# .##.### ####
## $     $ #  
 ####  #   #  
    ########  
