#####  ####   
#   ####  ##  
#          #  
## ##. #   #  
 #$##...   #  
 # ... $#  ###
 # ##.  ###  #
 # ##.$ # $$ #
 # #..##     #
 # $ ## $ $  #
 #  $@ $ #  ##
 ##  # $   ## 
  ####   ###  
     #####    
