#######
#  . @#
# $#$ #
#. * .#
# $#$ #
#  .  #
#######
