 ##########
## $  *.* #
#  $  *.* #
#  $  *.*@#
#  $  *.* #
#  $  *.* #
###########
