##################
#....#...........#
#.$$  $ $$$#$$$$.#
#.$ $ $ $   $  $.#
##$ $ $ $$  $@####
#.$ $ $ $   $  $.#
#.$  $$ $$$#$$$$.#
#....#...........#
##################
