   ####         
  ##  #### #### 
 ## $ $  ###  # 
## $  ##      # 
# $  #######  # 
#   ##     # ## 
## ###.... #  # 
#   ##..#.#   ##
# $$##....     #
#    ## # # @$ #
##  $ # #   ####
 ##      ####   
  ## $$ $ #     
   ###    #     
     ######     
