         ####      
      ####  #      
      #  #  ####   
   #### $# $#  #   
   #  #  $  $ $#   
   #..$  # $#  #   
   #..# $   $ $####
  ##.. #$# $#  #  #
  #..# #  @ # $ $ #
 ##...  # #  $ #  #
 #....    ## # $$ #
##.###### ## # #  #
# .            #  #
#   #########     #
#####       ####  #
               ####
