  #####   
###   ####
#  * * . #
# * * *  #
#  * *   #
#  ###$ ##
##  @#  # 
 ######## 
