  ####     ####  
  #  #######  ## 
  #  $ $ $ $   # 
  # #..... ##  # 
 ## #####.## $ ##
##  $  #.  # $  #
#      #.  #    #
# $  ##. @  #####
###$##.   # #    
 # $    #   #    
 #   #  #####    
 ########        
