 ###########
 #  #  #   #
 #  *  # # #
 #  #  #   #
 #$ #.*#  ##
##  #*.# $# 
#   #  #  # 
# # #  *  # 
#   # @#  # 
########### 
