    #####  
  ###   #  
###   # ## 
#   #$   # 
# #$.*.# ##
#  $.#.$  #
## #...$# #
 # #$$#   #
 #   @  ###
 ########  
