################# 
# .*.. $@  ##   ##
# .*.# $ $  $ $  #
##...# ### #$    #
 #.### ### #  $$ #
 #....  ## ##$$  #
 #$ $ $ ##    #  #
 #  ##############
 ####             
