########   
#  .$  #   
# .$.$.####
# * $.$ $ #
# .$.$.$.@#
## .$   ###
 #  #####  
 ####      
