#########
##     ##
# #.$ $ #
# .*.$  #
# $.#.$ #
#  $.#. #
# $ $.# #
##  @  ##
#########
