      ####  
      #  #  
      #  #  
      #  #  
########$#  
# $ ..*  #  
#   *.. $#  
#@$ *.*  #  
### *..# ###
 #  #.##   #
 # $$ $  $ #
 #  ########
 ####       
