 #####         ##### 
##   ## ####  ##   ##
#  #$ ###  #### $   #
#  $    $@       $# #
# $ $ ### ##### $ $ #
##   ###.....###   ##
 ## ##  .   .  ##$## 
 #  #   .#. .#     # 
 #     #. .#.   #  # 
 ##$##  .   .  ## ## 
##   ###.....###   ##
# $ $ ##### ### $ $ #
# #$        $    $  #
#   $ ####  ### $#  #
##   ##  #### ##   ##
 #####         ##### 
