    ####         
    #  # #####   
 ####  ###   #   
 #  #  #    $### 
## $ # #   $   ##
#   $ $@ #  $   #
# $  # ### $ $  #
##  #....##### ##
#  #.....#   #  #
# $$.....# $  $ #
#  #  ##### ##  #
## ###   ## #####
## ### $     #   
#  #### ##   #   
#        #####   
#  ###   #       
#### #####       
