   #####    
####   ##   
# $  $  ####
# # #*# $ @#
# $ #.# #  #
#  .....$$ #
### #.# #  #
  # #.#  ###
  # $ $  #  
  #####  #  
      ####  
