 ####            
 #  ######       
##     $ ###     
#   # ##   ######
#   .$  ## #    #
### #.#$@ $   # #
  # # ....##  $ #
  #$#.##$### $# #
  # .    # ##   #
  ########  #####
