#########
#.$ .  .#
# .$ $* #
# $@*. $#
# $*#*$ #
#  .*.$ #
#$.$ $. #
#.  . $.#
#########
