   #### ####    
   #  ###  ##   
   #..      ##  
  ##..###    ## 
 ##...   #    # 
##....#   #  $# 
#....## $  #  # 
#...####$$  #$##
###  #  $ $    #
  ##$#$ @  #   #
  #   $ $$  ####
  #   #  $ $ #  
  ###### $ $ #  
       # $   #  
       # $# ##  
       ##   #   
        #####   
