      ####
#######  #
# $ $ $  #
# ......@#
#  $ $ $ #
#  #######
####      
