    #####        
    #   #        
    #$  #        
  ###  $###      
  #  $  $ #      
### # ### #######
#   # ### ##.. .#
# $        ****.#
#####$#### #.. @#
    #      ######
    ########     
