       ####  
       #  #  
      ##  #  
 ######  $## 
 #   ##  . ##
 # $  ###*  #
 ##.# @  *  #
 # *  #  *  #
## *  #  *###
#  *#### *  #
#  *  ## *  #
#  *  ###.# #
###*  ## $  #
#  . ###   ##
#  $## ##### 
##  #        
 #  #        
 ####        
