 ##############
 #            #
## # ######## #
# $ $ $ $   # #
#           # #
##########$## #
#  $@$ $ $ .# #
# #......*..# #
# #########   #
#           ###
#############  
