 ####### 
##  .  ##
#  $*$  #
# $#.#$ #
#.*. .*.#
# $#.#$ #
#  $.$  #
#@  *   #
#########
