#####         
#   ##########
#    .....*.@#
#####$$$$$ ###
    #      #  
    # $#####  
    #  #      
    ####      
