    #######      
   ##  #  #      
   #  $ $ #      
 ### #$   ####   
 #  $  ##$   #   
 #  #$@ $ # $#   
 #  #      $ ####
 ## ####*##     #
 # $#.....# #   #
 #  *.*.*..$# ###
## $#.....#   #  
#   ###.#######  
# $$  #  #       
#  #   $ #       
######   #       
     #####       
