#########################
#  #   #    ##    #  #  #
#      # ## $ $#  $  #  #
##      $   #     #  $  #
#  #####$######## #  # ##
#  #..... #..*. # ####$##
## #***.. #.  . #   #   #
#  #..##### ##$#### #   #
#  #*.$      #      #$# #
#  #..    ## #$##  #    #
## #..     $ #  ## #    #
#  ############ $  ### ##
#           #   #$   #  #
#  #    @   #     #  #  #
#  ###########$##$#$##$##
## $                    #
#   ##  #  #  #  #  #   #
#########################
