       #####
   #####   #
   #.... $ #
####..### ##
#  $*.##  # 
#  #.. $$ # 
##  # ##  # 
 #$  @$  ## 
 # $$ $ ##  
 ##    ##   
  ######    
