        ###########
        #  #  #   #
   ######     # $ #
 ###  ##...#      #
## $ $ #... $#$$###
#   $ $#..##     # 
# $  $  ..######@# 
#   $ $#..##     # 
## $ $ #...  #$ ###
 ###  ##...#      #
   ######$   $# $ #
        #  #  #   #
        ###########
