###################
#        #.       #
# #$$$$$ #.#$$$$$ #
#        $........#
##########$########
#        $ .......#
# $$##$$ # $$##$$ #
#....... $        #
########$##########
#........$        #
# $$$$$#.# $$$$$# #
#       .#       @#
###################
