    #########    
    # . . . ##   
    #.$#$$$. ##  
##### $.  #$. #  
# . .  #$@.$ .###
#  $# $*  #$$$. #
#.$ *$ #$$$ . *.#
#  $# $. . .#####
##. $ .######    
 #  .  #         
 #######         
