#######
#  *  #
#  *  #
#  *  #
#.****#
#  *  #
# $*  #
#  * @#
#######
